isbn,cover,pages,original_publish_year,publish_year,rating,rating_count,republish_length
3125971403,Paperback,93,1943,2000,4.31,1277979,57
0060513039,Hardcover,176,1974,2002,4.3,1151744,28
0425245136,Hardcover,451,2009,2009,4.470000000000001,1084920,0
0060256656,Hardcover,64,1964,1964,4.38,876053,0
0099408392,Paperback,37,1963,2000,4.22,788702,37
0141301066,Paperback,240,1988,1998,4.319999999999999,606795,10
0394800168,Hardcover,62,1960,1988,4.3,589816,28
0451527747,Paperback,239,1871,2000,4.07,443721,129
0810993139,Hardcover,224,2004,2007,3.99,411413,3
039480001X,Hardcover,61,1957,1985,4.17,406186,28
1442416866,Hardcover,546,2012,2012,4.28,406002,0
0241003008,Board Book,26,1969,1994,4.3,381115,25
0517223627,Hardcover,92,1865,2004,4.03,374182,139
0141311371,Paperback,199,1982,2001,4.23,352522,19
156389470X,Paperback,212,1997,1999,4.09,344704,2
0439227143,Paperback,172,1903,2001,3.87,327078,98
0007173040,Hardcover,64,1957,2004,4.37,318139,47
0679805273,Hardcover,44,1990,1990,4.359999999999999,316082,0
0590032496,Paperback,208,1983,1997,4.18,297853,14
0679889108,Hardcover,72,1971,1998,4.35,272352,27
0060245867,Hardcover,40,1985,2015,4.26,243524,30
1631590758,Hardcover,248,1865,2015,4.02,223643,150
0395389496,Hardcover,32,1985,2000,4.3,207394,15
0001713221,Paperback,64,1960,1962,4.1899999999999995,206915,2
0723247706,Hardcover,72,1901,2002,4.18,199236,101
0920668372,Paperback,32,1986,1995,4.359999999999999,195857,9
0590133373,Paperback,44,1939,1989,4.23,188999,50
0670241334,Hardcover,32,1968,1968,4.3,187775,0
0805072373,Hardcover,224,1908,2003,3.99,171955,95
0545132053,Kindle Edition,224,2009,2014,4.25,168511,5
0689711735,Paperback,32,1972,1987,4.23,167901,15
0140544518,Paperback,32,1989,1996,4.3,163582,7
0613536843,Hardcover,144,1989,2001,4.48,160333,12
0007173687,Hardcover,64,1960,2003,4.14,157713,43
156389341X,Hardcover,197,1986,2012,4.26,157698,26
0439813786,Hardcover,533,2007,2007,4.24,156428,0
068983568X,Paperback,40,1989,2000,4.23,142246,11
0836220889,Paperback,128,1987,1987,4.6,138363,0
0810994739,Hardcover,224,2008,2008,4.13,131117,0
0689707495,Paperback,32,1978,1982,4.159999999999999,127560,4
8593828981,Paperback,240,2006,2018,4.09,124018,12
0747532036,Hardcover,64,1955,1996,4.25,123118,41
076360013X,Board Book,20,1988,2005,4.37,122636,17
037582913X,Hardcover,32,1971,2004,4.45,118599,33
0807508527,Paperback,160,1942,1989,4.109999999999999,115902,47
0810970686,Hardcover,218,2009,2009,4.14,115694,0
1558580093,Hardcover,24,1992,1992,4.17,115470,0
0517092913,Hardcover,803,1913,1996,4.28,114627,83
0810983915,Paperback,218,2009,2009,4.159999999999999,111557,0
0836218051,Paperback,256,1988,1988,4.64,110445,0
0152802177,Hardcover,46,1993,1993,4.24,105518,0
0793551617,Paperback,92,1996,1998,4.44,104698,2
006097625X,Paperback,215,1993,1993,3.97,102835,0
0140501827,Paperback,40,1962,1976,4.159999999999999,100605,14
0395401461,Paperback,32,1977,1985,4.29,98681,8
0679800034,Paperback,64,1954,1990,4.18,94244,36
067084487X,Hardcover,52,1992,1992,4.2,89787,0
0064431436,Paperback,48,1940,2015,4.1499999999999995,84768,75
0670674249,Hardcover,72,1936,1936,4.359999999999999,84158,0
0545326990,Paperback,238,2012,2012,4.2,83873,0
039921920X,Hardcover,32,1989,1989,4.26,83235,0
8424133498,Hardcover,44,1975,1996,4.24,82738,21
0670035386,Hardcover,64,1941,2001,4.22,82443,60
0064441555,Paperback,64,1963,2012,4.17,82084,49
0451529758,Paperback,368,1894,2005,4.02,81969,111
0064440206,Paperback,64,1970,2003,4.2,81613,33
0763635308,Hardcover,40,1905,2008,4.09,81038,103
0689832133,Hardcover,32,1999,2000,4.25,79258,1
0545540615,Kindle Edition,256,2016,2016,4.23,77666,0
1844280136,Hardcover,40,2003,2004,4.3,76100,1
0007174160,Paperback,159,1958,2018,4.23,73356,60
0307021343,Hardcover,24,1942,2001,4.109999999999999,73318,59
059044297X,Paperback,32,1963,1995,4.13,72720,32
1419705849,Hardcover,224,2012,2012,4.22,69289,0
1596431520,Paperback,240,2006,2006,3.88,69239,0
0439598389,Paperback,32,1998,2004,4.25,68111,6
0670175919,Hardcover,56,1948,1948,4.2,67043,0
0060775823,Hardcover,48,1942,2017,4.109999999999999,64484,75
072325804X,Hardcover,400,1930,2006,4.37,63207,76
1596437138,Hardcover,224,2011,2011,3.89,63025,0
0007158505,Paperback,65,1961,2003,4.31,62156,42
0312367481,Paperback,48,1968,2007,4.21,61586,39
0062011995,Hardcover,487,2011,2011,4.06,61586,0
0439846803,Hardcover,192,2008,2008,4.159999999999999,60276,0
1933718005,Hardcover,32,1993,1993,4.430000000000001,60111,0
0192750976,Paperback,192,1968,2000,4.06,60074,32
1419711326,Hardcover,217,2013,2013,4.29,59110,0
0689829531,Hardcover,40,2000,2000,4.14,58456,0
0545540607,Paperback,199,2014,2014,4.33,57963,0
0060266864,Hardcover,32,1998,1998,4.25,57716,0
0060244054,Hardcover,32,1991,1991,4.1899999999999995,56634,0
1608866874,Paperback,128,2015,2015,3.91,56551,0
1626720940,Hardcover,320,2014,2014,3.68,56273,0
0394805755,Hardcover,48,1931,1937,4.08,55408,6
1416980067,Hardcover,282,2009,2009,4.1499999999999995,55379,0
067056172X,Hardcover,32,1978,1978,4.31,54096,0
0007158475,Paperback,62,1965,2003,4.07,53702,38
0590319671,Paperback,64,1957,1999,4.24,53624,42
1419710206,Hardcover,233,2014,2014,4.22,52566,0
0545027896,Hardcover,640,2011,2011,4.17,50991,0
0688147321,Paperback,32,1991,2008,4.33,50541,17
0060268654,Hardcover,32,1956,2006,4.1899999999999995,50104,50
0486410226,Paperback,188,1906,2000,4.01,50083,94
0805053883,Hardcover,28,1982,1997,4.18,49852,15
0395169615,Hardcover,56,1938,1939,4.2,49184,1
0670869392,Hardcover,32,1997,1997,4.22,48196,0
1859855423,Hardcover,32,1997,2004,4.470000000000001,48087,7
0060082097,Paperback,326,2001,2004,3.78,46961,3
0920236162,Paperback,32,1980,1980,4.319999999999999,46941,0
0007169914,Paperback,32,1970,2003,4.119999999999999,46897,33
0439895294,Hardcover,132,2007,2007,4.33,46085,0
0590930028,Hardcover,32,1998,1998,4.14,45023,0
1844280594,Hardcover,40,2004,2005,4.2700000000000005,44355,1
067984483X,Paperback,72,1960,1988,4.14,44266,28
0375812156,Board Book,24,1960,2001,4.14,44264,41
0399230033,Board Book,32,1994,1996,4.22,44243,2
1416986561,Ebook,288,2010,2010,4.25,44174,0
0517266555,Hardcover,210,1902,2003,4.08,43738,101
0525467262,Hardcover,557,1961,2001,4.5,42455,40
0399255370,Hardcover,30,2013,2013,4.430000000000001,42432,0
067166154X,Hardcover,32,1969,1988,4.1499999999999995,41991,19
0399504338,Paperback,220,1972,1980,4.04,41914,8
0689878362,Paperback,48,1947,2005,4.24,41732,58
0803740166,Paperback,240,2015,2015,4.31,40906,0
0007175191,Paperback,64,1940,2004,4.17,40661,64
0679882812,Board Book,21,1963,1996,4.09,40244,33
0689853491,Paperback,40,1989,2003,4.28,40226,14
0448421658,Paperback,32,1933,2000,4.159999999999999,40212,67
0399214577,Hardcover,32,1987,1987,4.22,39724,0
069401298X,Paperback,64,1972,1999,4.23,39166,27
0307020711,Hardcover,24,1939,1976,4.31,38956,37
0152052216,Paperback,507,2003,2005,4.14,38863,2
0062012010,Hardcover,487,2012,2012,4.1899999999999995,38615,0
0670059838,Hardcover,40,2005,2005,4.3,38390,0
0061944343,Hardcover,224,2010,2010,4.21,37554,0
006440174X,Paperback,320,1981,1986,4.31,37413,5
068815932X,Hardcover,40,1843,1999,4.11,37194,156
076366040X,Hardcover,231,2013,2013,3.89,37190,0
0060283289,Hardcover,32,2002,2002,4.28,37118,0
0316201545,Hardcover,517,2013,2013,4.49,36829,0
0545176867,Hardcover,64,2011,2011,3.86,36819,0
0439014573,Paperback,125,1997,2000,3.96,36719,3
0553269216,Paperback,225,1919,1987,4.02,36700,68
0395181585,Hardcover,48,1966,1973,4.24,36416,7
0142004413,Paperback,273,1956,2004,4.25,36413,48
0859536599,Board Book,32,1984,1998,4.32,36070,14
0399229191,Board Book,26,1984,1995,4.21,35684,11
0575077352,Paperback,192,1985,2003,4.44,35042,18
0590225170,Hardcover,128,1916,1994,4.34,34517,78
0590414275,Paperback,40,1989,1990,4.27,34077,1
1442411902,Kindle Edition,320,2011,2011,4.3,34056,0
0786837462,Hardcover,40,2006,2006,4.34,33754,0
0064440591,Paperback,64,1976,1984,4.36,33336,8
0007169973,Paperback,62,1961,2003,4.13,33122,42
0061906220,Hardcover,40,2010,2010,4.34,33078,0
188896314X,Paperback,1344,1991,2010,4.430000000000001,32587,19
0224064924,Paperback,80,1990,2003,3.74,32499,13
0808553038,Hardcover,215,1967,2009,3.83,32415,42
0525471340,Hardcover,32,2003,2003,4.24,32278,0
0590316818,Hardcover,40,2000,2000,4.16,32144,0
0394856392,Paperback,32,1983,1983,4.18,32050,0
0439846838,Paperback,220,2009,2009,4.33,32023,0
0679847596,Paperback,233,1936,2003,4.07,31814,67
006194436X,Hardcover,216,2010,2010,4.25,31560,0
0064430960,Paperback,32,1964,1993,4.21,31237,29
0064434508,Paperback,48,1977,1996,4.11,31104,19
0689861133,Hardcover,14,1982,2004,4.2,31057,22
0316381306,Paperback,224,2015,2015,4.109999999999999,31021,0
0679824111,Paperback,68,1992,1992,3.92,30750,0
0805017585,Hardcover,32,2003,2003,4.23,30669,0
0316406813,Hardcover,448,2014,2014,4.52,29903,0
1449410243,Paperback,131,2012,2012,3.94,29646,0
0859537277,Board Book,14,1973,2000,4.22,29424,27
039541668X,Paperback,32,1982,1982,4.34,29133,0
0810909650,Hardcover,212,1976,1977,4.02,29013,1
000710653X,Paperback,252,1977,2000,3.97,29009,23
006443253X,Paperback,32,1962,1991,4.25,28998,29
0689831870,Hardcover,34,2002,2002,4.26,28784,0
0899197698,Hardcover,32,1989,1989,4.11,28600,0
0333710932,Paperback,32,1999,1999,4.49,28511,0
0688128971,Hardcover,40,1996,2006,4.21,28436,10
0064440028,Paperback,64,1958,1978,4.02,28420,20
0399226168,Hardcover,40,1995,1995,4.18,28355,0
0007169957,Paperback,30,1974,2003,4.03,28332,29
0590416022,Paperback,32,1971,1986,4.29,28117,15
006000150X,Hardcover,40,1996,2003,4.21,27764,7
0545741653,Hardcover,224,2015,2015,4.119999999999999,27713,0
0679890483,Board Book,24,1969,1998,4.22,27625,29
0670447161,Hardcover,56,1953,1981,4.25,27449,28
1596436581,Paperback,175,2014,2014,3.81,27241,0
087923573X,Paperback,315,1930,2010,4,27113,80
0679882804,Board Book,24,1968,1996,4.02,26973,28
0997895810,Hardcover,212,2016,2016,4.35,26930,0
0307119408,Paperback,24,1983,2001,4.23,26864,18
0763619612,Hardcover,32,2003,2003,4.19,26774,0
1423102991,Hardcover,42,2007,2007,4.29,26762,0
0395137209,Paperback,48,1965,1987,4.14,26464,22
0785113797,Paperback,144,2006,2006,3.97,26070,0
0060256710,Hardcover,112,1976,2006,4.28,25997,30
0743490096,Paperback,32,2002,2004,4.21,25910,2
0307960307,Hardcover,24,1954,2001,4.23,25821,47
0785129219,Hardcover,216,2009,2009,4.09,25791,0
0064434516,Paperback,32,1960,1995,4.15,25766,35
0689846231,Paperback,513,1938,2001,4,25625,63
0836221362,Paperback,176,1996,1996,4.76,25572,0
968163666X,Hardcover,22,1981,1995,4.05,25390,14
0395304482,Hardcover,32,1981,1981,4.05,25389,0
0786818697,Hardcover,40,2004,2004,4.35,25383,0
0060734000,Paperback,289,2001,2005,3.86,25284,4
0140549056,Paperback,32,1975,1992,4.03,25099,17
0545208858,Paperback,203,2010,2010,4.359999999999999,24793,0
0060542098,Hardcover,32,2005,2005,4.17,24640,0
0152018484,Hardcover,44,2003,2003,4.08,24563,0
0763655988,Hardcover,40,2011,2011,4.39,24560,0
0316381993,Hardcover,279,2016,2016,4.13,24498,0
0618194576,Hardcover,40,2006,2006,4.25,24378,0
0395870828,Paperback,32,1991,2011,4.18,24377,20
0671449028,Board Book,14,1982,1982,4.23,24046,0
0140505393,Paperback,32,1982,1985,4.46,24039,3
0689823827,Hardcover,67,1885,1999,4.3,24027,114
0517285258,Hardcover,336,1909,1988,4.13,23433,79
0439287197,Hardcover,32,2001,2001,4.31,23090,0
067122350X,Hardcover,65,1955,1969,4.2,22945,14
0316123080,Hardcover,258,2012,2012,3.84,22806,0
1442449616,Hardcover,368,2012,2012,4.39,22516,0
0394826205,Paperback,32,1963,1973,4.14,22472,10
1616550546,Paperback,76,2013,2013,4.31,22428,0
0698113578,Paperback,64,1938,1996,4.19,22283,58
0836217357,Paperback,176,1993,1993,4.7,22159,0
0307444058,Hardcover,18,1940,1999,4.07,22116,59
0060588284,Hardcover,40,2004,2004,4.1,22084,0
0545175305,Hardcover,176,2010,2010,4.2,22048,0
0590259385,Board Book,28,1989,1997,4.17,22044,8
0823404706,Hardcover,32,1983,1983,4.13,22041,0
0316013560,Hardcover,40,2009,2009,4.24,21909,0
0060514094,Paperback,371,2002,2004,3.89,21855,2
141694737X,Board Book,18,1982,2007,4.28,21839,25
1595828117,Paperback,76,2012,2012,4.25,21807,0
0824965973,Hardcover,32,1894,2000,3.99,21754,106
0007169922,Paperback,64,1937,2003,4,21740,66
0688143202,Hardcover,48,1894,1997,3.99,21736,103
1626724164,Hardcover,224,2017,2017,4.18,21701,0
0064440583,Paperback,64,1979,2004,4.25,21689,25
1563054426,Board Book,24,1993,1993,4.26,21628,0
1423109600,Hardcover,40,2008,2008,4.36,21595,0
0439643635,Paperback,32,1845,2003,4.09,21244,158
1529105102,Hardcover,128,2019,2019,4.64,20957,0
0803741715,Hardcover,48,2014,2014,4.37,20702,0
0545581605,Hardcover,231,2016,2016,4.21,20647,0
0751507954,Paperback,254,1990,1990,4.74,20598,0
0060283262,Hardcover,32,2000,2005,4.24,20542,5
0679887571,Hardcover,48,1836,1993,4.01,20415,157
0698400011,Hardcover,48,1836,2004,4.01,20391,168
0811879542,Hardcover,56,2010,2011,4.44,20328,1
0307111547,Paperback,20,1942,1982,4.29,20164,40
0836218523,Paperback,128,1989,1989,4.67,20067,0
0394800230,Hardcover,64,1961,1989,4.22,20056,28
0375836977,Hardcover,40,1975,2006,4.26,20029,31
1616882247,Paperback,256,1961,1997,3.97,19924,36
0142407089,Paperback,32,1928,2006,4.09,19719,78
0307960382,Hardcover,24,1992,2001,4.35,19637,9
0836213122,Paperback,176,1996,1996,4.75,19516,0
0688040454,Hardcover,32,1986,2018,4.34,19499,32
0060278684,Hardcover,40,2000,2000,4.16,19494,0
1608867374,Paperback,126,2015,2015,4.17,19465,0
0545208874,Paperback,219,2011,2011,4.39,19415,0
0140546235,Paperback,32,1980,1992,4.18,19393,12
0751500283,Paperback,255,1992,1992,4.74,19235,0
0060776390,Hardcover,32,2006,2016,4.06,19188,10
0618007016,Hardcover,38,2001,2001,4.16,19182,0
0763655996,Hardcover,40,2012,2012,4.26,19131,0
0316317780,Hardcover,448,2016,2016,4.49,19061,0
0375803017,Paperback,145,1972,1999,3.84,19018,27
0061119725,Paperback,32,1997,2007,4.2,18958,10
0399218858,Hardcover,32,1990,1990,4.07,18898,0
0394837363,Paperback,32,1978,1978,4.31,18830,0
1596434023,Hardcover,32,2010,2010,4.27,18751,0
0374386153,Hardcover,392,2012,2012,3.9,18545,0
0803725507,Hardcover,32,2002,2002,4.25,18353,0
0375868429,Hardcover,290,2012,2012,3.96,18139,0
0694011479,Board Book,32,1975,1998,4.22,18131,23
0007158513,Paperback,48,1978,2003,4.2,18059,25
0590480871,Hardcover,32,1999,1999,4.17,18041,0
0345496205,Paperback,187,2005,2007,4.17,18033,2
0694006513,Board Book,32,1982,1995,4.19,18014,13
1585678449,Paperback,704,1999,2006,4.24,17984,7
0375832297,Paperback,96,2005,2005,3.87,17964,0
1468307193,Ebook,704,1999,2006,4.24,17956,7
0307118398,Paperback,24,1977,2001,4.21,17914,24
0307021521,Hardcover,24,1953,2000,4.23,17900,47
0307140210,Hardcover,20,1950,1950,4.26,17899,0
0670446149,Hardcover,54,1956,1957,4.28,17894,1
0670062405,Hardcover,32,2007,2007,4.29,17790,0
0307119394,Paperback,24,1983,2000,4.22,17716,17
0836217691,Paperback,176,1994,1994,4.72,17584,0
0375834869,Hardcover,384,2009,2009,3.95,17477,0
1844285073,Paperback,48,1952,2004,4.25,17329,52
0688114490,Hardcover,32,1993,1993,4.25,17237,0
145210655X,Hardcover,64,2012,2012,4.1499999999999995,17218,0
0307021106,Hardcover,24,1947,1999,4.08,17155,52
0688170277,Hardcover,32,2000,2000,4.23,17132,0
0399216197,Hardcover,32,1989,1989,4.05,17062,0
0439050227,Hardcover,32,2002,2002,4.23,17056,0
0545448689,Hardcover,664,2015,2015,3.97,17039,0
0142302260,Paperback,48,1982,2003,4.159999999999999,16965,21
0064431835,Paperback,32,1986,2019,4.26,16835,33
0670878553,Hardcover,40,1977,1999,4.13,16802,22
0823404420,Hardcover,32,1835,1988,4.109999999999999,16679,153
1413903177,Paperback,224,2003,2005,4.319999999999999,16665,2
0316236535,Hardcover,32,1992,2005,4.22,16633,13
0061953385,Hardcover,40,2012,2012,4.1,16514,0
067988632X,Board Book,48,1968,1997,4.1499999999999995,16453,29
0606300538,Hardcover,32,1965,2004,4.48,16386,39
0140504206,Paperback,24,1980,1983,4.09,16373,3
0399237321,Hardcover,40,1998,2001,4.53,16296,3
0440406943,Paperback,192,1962,1992,4.4,16254,30
0142302457,Paperback,32,1978,2003,3.78,16249,25
0140558640,Paperback,40,1986,1996,4.24,16205,10
159582748X,Paperback,240,2011,2011,4.39,16166,0
0543896609,Paperback,242,1883,2001,3.81,16166,118
039586786X,Board Book,26,1986,1997,4.12,16068,11
0525456074,Hardcover,36,1997,1997,4.17,15828,0
0099417472,Paperback,40,1970,2001,4.04,15795,31
0810987880,Paperback,209,2004,2005,3.4499999999999997,15672,1
1857933362,Hardcover,64,1994,1994,4,15595,0
0061944394,Hardcover,224,2011,2011,4.35,15571,0
0394839730,Hardcover,32,1978,1978,4.29,15552,0
0395570352,Hardcover,32,1993,1993,4.13,15520,0
0688149006,Board Book,26,1978,1996,4.06,15515,18
067088278X,Board Book,34,1978,1999,4.25,15497,21
0689717385,Paperback,32,1985,1993,4.21,15477,8
0763641685,Hardcover,40,2010,2010,4.21,15461,0
0545208890,Paperback,203,2012,2012,4.38,15445,0
159990070X,Hardcover,144,2008,2008,3.88,15428,0
1596434465,Paperback,186,2011,2011,4.08,15399,0
0380810956,Paperback,56,2003,2003,4.07,15369,0
0142501123,Paperback,32,2001,2003,4.46,15264,2
0152010661,Board Book,28,1993,1997,4.17,15261,4
0140376410,Paperback,311,1994,1995,3.86,15250,1
0140547126,Paperback,32,1968,1992,4.23,15022,24
0152002650,Board Book,32,1989,1995,4.16,14991,6
3570033120,Hardcover,186,1942,1966,4.03,14905,24
1596433590,Paperback,328,2013,2013,3.88,14891,0
0745917437,Hardcover,25,1989,1989,4.54,14885,0
1423133080,Hardcover,57,2010,2010,4.58,14829,0
072324734X,Hardcover,96,2003,2003,4.46,14803,0
0723247757,Hardcover,58,1905,2002,4.2,14655,97
1607060922,Paperback,184,2009,2009,4.14,14638,0
0394823958,Hardcover,36,1972,2007,4.159999999999999,14620,35
006444001X,Paperback,64,1970,2003,4.26,14609,33
0439700418,Hardcover,34,2003,2003,4.16,14575,0
0694004928,Board Book,32,1945,2020,4.08,14542,75
0439434521,Paperback,32,1994,2002,4.38,14464,8
1405208198,Hardcover,62,1959,2008,4.22,14442,49
0312346069,Hardcover,32,2005,2006,4.36,14334,1
043977733X,Hardcover,40,2007,2007,4.49,14262,0
0786812400,Paperback,288,2000,2003,4.03,14258,3
043933909X,Hardcover,32,2003,2003,4.17,14250,0
0723247730,Hardcover,58,1904,2002,4.27,14231,98
0439050235,Hardcover,40,2002,2002,4.08,14180,0
1557091447,Hardcover,214,1927,1991,3.91,14141,64
0867199032,Hardcover,120,1930,2003,3.64,14118,73
0060206802,Hardcover,48,1964,1964,3.84,14041,0
0140504419,Paperback,40,1979,1983,4.05,14027,4
1423102959,Hardcover,57,2007,2007,4.33,13925,0
1553379594,Hardcover,40,2006,2006,4.25,13916,0
0006640613,Paperback,32,1968,1992,4.25,13889,24
0374418101,Paperback,32,1982,1990,4.14,13854,8
006246776X,Hardcover,34,2017,2017,4.34,13806,0
0545141028,Paperback,224,2009,2011,4.34,13806,2
0307021688,Hardcover,24,1952,2001,4.17,13679,49
0064440516,Paperback,64,1960,1984,4.31,13671,24
0811849090,Paperback,120,2006,2007,3.93,13660,1
0060283246,Hardcover,32,2008,2008,4.2,13587,0
0395861624,Hardcover,32,1998,1998,4.19,13470,0
0679863729,Paperback,67,1995,1995,3.94,13464,0
0062051857,Hardcover,32,1999,1999,4.21,13453,0
145217380X,Kindle Edition,34,2018,2018,4.72,13375,0
1596436891,Paperback,170,2013,2013,3.84,13329,0
0316358320,Paperback,62,1943,1974,4.29,13305,31
0670913502,Board Book,36,1983,2002,4.29,13279,19
0803710402,Hardcover,32,1991,2016,4.35,13259,25
0375415122,Hardcover,96,1844,2002,3.74,13248,158
0316358363,Ebook,63,1934,1934,4.06,13224,0
1405206233,Paperback,62,1943,2012,4.2700000000000005,13214,69
0671449044,Board Book,14,1982,1982,4.23,13196,0
0394800516,Hardcover,64,1968,1968,4.2,13134,0
1620104415,Hardcover,72,2017,2017,4.359999999999999,13064,0
0007173156,Paperback,64,1975,1975,4.13,12982,0
0061996610,Hardcover,224,2012,2012,4.45,12967,0
0545418739,Paperback,288,2012,2012,4.14,12907,0
044046126X,Paperback,80,1972,1977,4.03,12894,5
0618344217,Hardcover,48,1837,2004,3.96,12880,167
1888963166,Paperback,232,2004,2004,4.470000000000001,12821,0
1596430699,Hardcover,40,2005,2005,4.2,12807,0
1416975578,Paperback,160,2006,2008,3.58,12758,2
0152056610,Hardcover,32,2008,2008,4.49,12722,0
0061123226,Hardcover,32,2006,2006,4.28,12659,0
0590442872,Paperback,32,1966,1986,4.159999999999999,12642,20
0763620793,Hardcover,40,1835,2009,4.109999999999999,12594,174
0307020754,Board Book,21,1961,1961,4.3,12509,0
0439339111,Hardcover,40,2005,2005,4.24,12474,0
0439673631,Board Book,24,2005,2005,4.39,12468,0
0439023459,Paperback,368,2007,2009,3.93,12445,2
1608862801,Paperback,128,2011,2012,4.2700000000000005,12419,1
0670061980,Hardcover,40,2009,2009,4.34,12379,0
0140501746,Paperback,64,1952,1980,4.37,12361,28
0786852941,Hardcover,48,2005,2005,4.23,12358,0
0439568277,Paperback,144,1993,2003,3.67,12331,10
0140565337,Paperback,32,1997,2000,4.26,12328,3
0399172750,Hardcover,48,2015,2015,4.44,12242,0
140520625X,Paperback,62,1946,2002,4.22,12233,56
162672444X,Hardcover,256,2018,2018,4.03,12217,0
0525429980,Hardcover,248,2017,2017,4.08,12212,0
0517586592,Paperback,102,1816,1991,4.02,12155,175
068981528X,Paperback,32,1993,1997,4.21,12095,4
0545210283,Paperback,272,2010,2010,4.04,12080,0
1442402970,Hardcover,32,2012,2012,4.21,12053,0
1449402321,Paperback,224,2010,2010,4.4,12018,0
1442422335,Hardcover,288,2011,2011,4.28,11980,0
0545433150,Paperback,224,2014,2014,4.359999999999999,11975,0
0439598443,Paperback,32,1995,2004,4.43,11910,9
1402771576,Hardcover,48,1812,2010,4.17,11893,198
0618065687,Paperback,24,2003,2003,4.26,11871,0
0152025057,Paperback,306,1951,2000,3.68,11764,49
0140344438,Paperback,144,1981,1990,3.95,11746,9
0590419625,Paperback,32,1989,1989,4.2,11742,0
0152055789,Hardcover,32,1985,2005,4.22,11724,20
0439376068,Paperback,128,2002,2002,4.23,11673,0
0439269970,Paperback,246,2004,2005,4.04,11592,1
0375846832,Paperback,96,2009,2009,4.01,11566,0
1416903097,Paperback,32,1987,2005,4.14,11562,18
0694006246,Board Book,32,1956,1995,4.19,11549,39
0723247781,Hardcover,57,1908,2002,4.08,11544,94
0316045462,Hardcover,40,2011,2011,4.13,11504,0
0439739365,Paperback,144,2006,2006,4.38,11475,0
0689842449,Paperback,40,1970,2001,4.14,11464,31
0374360979,Board Book,32,2008,2013,4.31,11429,5
0345331044,Paperback,240,1976,1980,4.01,11429,4
0316020362,Hardcover,29,1986,1986,4.5,11418,0
0395185629,Paperback,40,1943,1974,4.24,11417,31
0374360960,Hardcover,32,2008,2008,4.31,11397,0
0698116267,Paperback,32,1998,1998,4.39,11386,0
0399257748,Hardcover,32,2015,2015,4.3,11383,0
0828850712,Paperback,63,1948,1979,4.2,11319,31
0152024883,Hardcover,32,2005,2005,4.27,11301,0
1641448008,Kindle Edition,27,2014,2014,4.02,11232,0
0060530642,Paperback,160,1992,2003,4.25,11201,11
054514096X,Paperback,128,2010,2010,4.38,11186,0
0618512659,Paperback,111,1976,2004,4.25,11171,28
0803736800,Hardcover,32,2012,2012,4.17,11161,0
0439885167,Paperback,160,2007,2007,4.38,11156,0
0395562333,Paperback,32,1988,1990,4.28,11144,2
0316199982,Hardcover,40,2014,2014,4.31,11124,0
0061131628,Hardcover,320,1971,2006,4.25,11107,35
1442457023,Hardcover,52,2011,2012,4.52,11102,1
0688091717,Hardcover,32,1989,1989,4.23,11093,0
0803729952,Hardcover,32,2005,2005,4.2,11056,0
0062110586,Hardcover,40,2012,2012,4.4,11050,0
0723247765,Hardcover,57,1906,2002,4.15,11039,96
0698114434,Paperback,32,1992,1997,4.01,11020,5
1423106865,Hardcover,64,2007,2007,4.44,11011,0
0399226710,Hardcover,48,1994,1994,4.48,10993,0
0061910244,Hardcover,40,2011,2011,4.32,10991,0
194130267X,Paperback,239,2018,2018,3.76,10933,0
031236752X,Paperback,32,2002,2007,3.89,10927,5
030712584X,Paperback,24,1990,2001,4.23,10916,11
0735814864,Paperback,32,1812,2002,4.23,10864,190
0394829123,Hardcover,48,1974,1974,4.21,10830,0
0811868656,Hardcover,32,2009,2009,4.17,10824,0
1936976552,Paperback,256,2014,2014,3.93,10821,0
0394873343,Paperback,32,1985,1985,3.88,10790,0
0860915468,Paperback,224,1983,1991,4.1,10778,8
0849976820,Hardcover,40,1995,2000,4.43,10762,5
0761119752,Board Book,24,2000,2000,4.2,10703,0
2203001046,Hardcover,62,1935,1999,4.05,10673,64
1405206187,Paperback,62,1943,2007,4,10647,64
1452118698,Hardcover,64,2013,2013,4.109999999999999,10633,0
0439725267,Hardcover,40,1972,2005,4.1899999999999995,10631,33
1449446205,Paperback,222,2014,2014,4.1,10602,0
0439885175,Paperback,174,2008,2008,4.4,10593,0
0786807148,Hardcover,40,2001,2001,4.45,10571,0
0312085125,Hardcover,260,1992,1992,4.45,10506,0
0316187488,Hardcover,32,2013,2013,4.1,10487,0
0670762407,Hardcover,40,1964,1964,4.25,10454,0
0763660531,Hardcover,40,2013,2013,4.41,10451,0
0547199457,Hardcover,40,2011,2011,4.15,10428,0
0811877825,Hardcover,32,2011,2011,4.36,10285,0
0007216092,Paperback,32,2005,2006,4.11,10215,1
1423121902,Hardcover,40,2011,2011,4.16,10201,0
1423151283,Hardcover,40,2012,2012,4.4,10148,0
1888963093,Paperback,184,2001,2008,4.359999999999999,10121,7
1888963050,Paperback,128,1997,1999,4.37,10107,2
006443348X,Paperback,32,1971,1994,4.17,10098,23
0060587016,Hardcover,64,1997,2004,4.03,10060,7
0395159903,Hardcover,46,1939,1967,4.33,10034,28
1405206284,Paperback,62,1953,2002,4.2,9982,49
1569319030,Paperback,200,1998,2003,4.09,9945,5
0671493205,Board Book,14,1984,1984,4.21,9943,0
0060831545,Hardcover,40,2008,2008,4.16,9930,0
043970636X,Paperback,116,1998,2007,4.3,9930,9
0803705425,Hardcover,32,1988,1988,4.06,9880,0
0670060267,Hardcover,32,1983,2006,4,9845,23
038560937X,Hardcover,32,2005,2005,4.119999999999999,9804,0
0061929573,Hardcover,52,2010,2010,4.4,9762,0
0140544577,Paperback,32,1992,1994,4.05,9750,2
1591164087,Paperback,130,1982,2004,4.470000000000001,9746,22
0763622702,Hardcover,68,2005,2005,4.06,9725,0
0439669901,Paperback,144,1993,2005,3.67,9700,12
0395851580,Hardcover,352,1972,1997,4.2,9695,25
0140319298,Paperback,279,1953,1985,4.23,9692,32
0689845049,Hardcover,32,1978,2001,4.11,9688,23
0416605109,Hardcover,62,1939,1997,4.01,9688,58
076362344X,Hardcover,32,2004,2004,4.36,9683,0
0316363189,Paperback,248,2017,2017,4.34,9681,0
0399227741,Hardcover,32,1995,1995,4.16,9658,0
0152025413,Paperback,212,1941,2001,4,9656,60
0545609992,Paperback,160,2013,2013,4.23,9585,0
0416851703,Paperback,64,1976,1993,4.02,9585,17
1407120697,Paperback,256,2011,2011,4.159999999999999,9531,0
0525467343,Hardcover,32,1969,2001,4.4,9456,32
0486286118,Paperback,240,1906,1995,4.04,9378,89
1405206217,Paperback,62,1942,2002,3.9,9372,60
0064430111,Paperback,32,1958,1976,4.25,9362,18
0590442481,Paperback,208,1980,1991,4.02,9340,11
0140364501,Paperback,244,1963,2010,3.94,9293,47
0689858817,Hardcover,40,2004,2004,4.15,9282,0
0152019901,Board Book,30,1994,1999,4.12,9270,5
0064432521,Paperback,48,1962,1991,4.28,9236,29
0689807481,Board Book,36,1985,1996,4.25,9226,11
1405206268,Paperback,64,1950,2002,4.02,9186,52
037585861X,Hardcover,32,2011,2011,3.88,9175,0
0763622621,Hardcover,48,2006,2006,4.39,9157,0
0439579287,Hardcover,40,2002,2002,4.22,9147,0
0689835604,Board Book,14,2000,2000,4.02,9126,0
1554983606,Hardcover,104,2012,2013,4,9126,1
0553213660,Paperback,258,1911,1988,3.98,9121,77
1423102975,Hardcover,64,2007,2007,4.36,9120,0
0857072188,Paperback,563,2011,2011,4.5,9096,0
1596431083,Paperback,208,2007,2007,3.93,9039,0
0786809140,Hardcover,32,2005,2005,3.87,9022,0
0545433169,Paperback,199,2016,2016,4.42,9012,0
0440228239,Paperback,212,1998,2000,3.99,9009,2
0810932652,Hardcover,32,1988,1993,4.31,8959,5
0689878451,Hardcover,32,2005,2005,4.34,8958,0
0399257373,Hardcover,32,2011,2011,4.23,8948,0
1596438061,Hardcover,224,2012,2012,4.23,8947,0
0062104187,Hardcover,40,2012,2012,4.21,8931,0
3522174399,Paperback,124,1957,2001,4.1899999999999995,8895,44
0307118932,Paperback,24,1983,2001,4.24,8893,18
0888992122,Hardcover,32,1812,1996,4.06,8879,184
0717283372,Paperback,40,1993,1993,4.359999999999999,8857,0
0810992795,Paperback,256,2006,2007,3.7,8849,1
0152053530,Hardcover,44,2007,2007,4.16,8824,0
0394893301,Hardcover,32,1988,2003,4.03,8823,15
1452150133,Hardcover,44,2016,2016,4.06,8703,0
0399243046,Hardcover,224,2006,2006,3.85,8681,0
0440414539,Paperback,181,1997,1999,3.87,8624,2
1596435828,Paperback,208,2012,2012,4.03,8617,0
014036739X,Paperback,289,1904,1994,4.05,8615,90
1423190874,Hardcover,40,2014,2014,4.39,8610,0
0153052120,Paperback,32,1988,2001,4.4,8589,13
0307157857,Hardcover,72,1974,1998,4.26,8553,24
0316109215,Paperback,32,1993,1995,4.34,8548,2
9129657903,Paperback,98,1963,2004,4.3,8513,41
1888963131,Paperback,144,2002,2002,4.35,8509,0
0007169949,Paperback,64,1950,2003,3.87,8507,53
0545175321,Hardcover,192,2011,2011,4.31,8479,0
0688200672,Hardcover,160,1973,2008,3.92,8472,35
0380709260,Paperback,160,1973,2015,3.92,8464,42
0805070605,Hardcover,177,1941,2002,4.1499999999999995,8457,61
1596433418,Hardcover,128,2008,2008,4.2,8438,0
0152632247,Paperback,32,1983,1991,4.18,8428,8
0916291561,Paperback,32,1984,1995,4.42,8416,11
159643659X,Paperback,280,2013,2013,3.85,8406,0
0689852789,Hardcover,40,2004,2004,4.28,8403,0
1449407188,Paperback,224,2011,2011,4.4,8382,0
0060256532,Hardcover,96,2005,2015,4.119999999999999,8380,10
0439298199,Paperback,218,2011,2011,4.119999999999999,8354,0
0399243178,Hardcover,48,2000,2012,3.96,8351,12
0836218515,Paperback,288,1989,1989,4.52,8340,0
0517885441,Paperback,32,1991,1996,4.12,8334,5
1405206330,Paperback,62,1968,2002,3.97,8333,34
0152024689,Paperback,192,1954,2002,4.02,8303,48
0060001534,Hardcover,40,1996,2005,4.26,8302,9
3791530119,Hardcover,176,1949,2013,4.119999999999999,8288,64
1939352541,Paperback,140,2012,2012,4,8287,0
0142407496,Paperback,32,2005,2007,4.26,8261,2
081182778X,Hardcover,34,2000,2000,4.35,8261,0
0375810390,Hardcover,48,1981,2000,4.05,8258,19
0395259371,Paperback,80,1958,1977,4.24,8250,19
0439206634,Hardcover,32,2002,2003,4.21,8248,1
0723247773,Hardcover,58,1907,2002,4.08,8208,95
0763623296,Hardcover,32,2003,2003,4.109999999999999,8207,0
1419708457,Hardcover,32,2013,2013,4.55,8163,0
0316015482,Hardcover,40,2010,2010,4.11,8156,0
0771084021,Hardcover,96,2008,2008,4.319999999999999,8151,0
0307165485,Hardcover,288,1950,1968,4.23,8149,18
0064400999,Paperback,192,1942,2000,4.18,8142,58
0545229243,Hardcover,128,2011,2011,4.18,8139,0
0486466078,Paperback,192,1902,2008,3.92,8137,106
0142300497,Paperback,304,1999,2001,3.94,8131,2
0007150369,Paperback,32,2004,2015,4.35,8120,11
0394809149,Hardcover,40,1969,1969,4.15,8107,0
0810943247,Hardcover,316,2009,2009,3.91,8103,0
1401254721,Paperback,160,2015,2015,3.95,8099,0
0750007745,Paperback,32,1871,1991,4.2,8078,120
0060239743,Hardcover,48,1980,1980,4.14,8078,0
0399244816,Paperback,148,2007,2007,4.29,8073,0
1596436077,Hardcover,32,2011,2011,4.11,8069,0
1405206306,Paperback,64,1958,2002,3.99,8069,44
2203001011,Hardcover,62,1930,1999,3.23,8042,69
1595829415,Paperback,76,2012,2012,4.37,8026,0
014034912X,Paperback,288,1974,1992,4.09,8020,18
0689845073,Hardcover,40,2006,2006,4.1,8003,0
0698118952,Paperback,40,1992,2002,4.2,7963,10
006248494X,Hardcover,192,2017,2017,4.04,7961,0
0374460345,Paperback,32,1697,1998,4.119999999999999,7915,301
0375800999,Board Book,12,1973,1999,4.21,7892,26
0689837372,Hardcover,42,2003,2003,4.14,7876,0
054415777X,Hardcover,96,2015,2015,4.03,7872,0
0061240206,Paperback,96,2007,2007,4.119999999999999,7869,0
379150455X,Hardcover,191,1998,1998,3.85,7846,0
0810984210,Hardcover,208,2010,2010,4.09,7845,0
1782690263,Paperback,512,1962,2014,4.159999999999999,7843,52
0763615781,Hardcover,96,2007,2007,3.65,7828,0
0618862447,Hardcover,40,2008,2008,3.87,7818,0
0061458562,Hardcover,90,2008,2008,4.21,7810,0
0811818071,Hardcover,40,1997,1997,4.15,7802,0
1570625387,Paperback,74,1953,2000,4.23,7800,47
0060278226,Hardcover,253,1999,1999,3.82,7796,0
0763621803,Paperback,32,2000,2003,4.22,7745,3
0307119432,Paperback,24,1983,1999,4.28,7743,16
0152057277,Hardcover,155,2009,2009,4.02,7736,0
0060268522,Hardcover,64,1960,1960,4.21,7727,0
0330404369,Paperback,256,2011,2011,4.04,7727,0
1101918713,Paperback,64,2016,2016,4.23,7719,0
0307203123,Board Book,26,1956,2001,4.359999999999999,7708,45
1853261483,Paperback,224,1863,1994,3.42,7698,131
0099413124,Paperback,224,1928,2001,3.97,7662,73
0374435251,Paperback,192,1965,1987,3.73,7656,22
0394811992,Hardcover,36,1968,1968,4.1899999999999995,7652,0
0062203096,Hardcover,42,2013,2013,4.23,7591,0
0316068748,Hardcover,40,2009,2009,3.98,7589,0
081091266X,Hardcover,288,2007,2007,3.77,7568,0
0399231161,Hardcover,32,2001,2001,4.5,7561,0
0670861944,Hardcover,32,1995,1995,4.17,7539,0
0763662291,Hardcover,40,2014,2014,4.16,7506,0
0688092349,Paperback,24,1989,1989,4.15,7504,0
0439703840,Hardcover,32,2003,2003,4.15,7491,0
142311437X,Hardcover,40,2009,2009,4.15,7475,0
0803720017,Hardcover,32,1831,1996,4.23,7465,165
0140367438,Paperback,291,1907,1994,3.85,7463,87
1405020458,Hardcover,32,2004,2004,4.34,7448,0
0689822847,Paperback,256,1929,1998,3.86,7432,69
0394839102,Hardcover,48,1978,1978,4.17,7420,0
1591169178,Paperback,184,2001,2005,4.01,7413,4
0689716230,Paperback,242,1989,2009,3.93,7407,20
0689829914,Paperback,144,1979,1999,3.56,7390,20
1524766496,Kindle Edition,32,2017,2017,4.29,7382,0
1423103009,Hardcover,64,2010,2010,4.18,7365,0
0859531511,Hardcover,32,1982,2001,4.12,7340,19
0316367958,Paperback,32,1984,1990,4.18,7336,6
0140501177,Paperback,32,1972,1975,4.05,7301,3
0060799846,Hardcover,32,2012,2012,4.14,7293,0
0439551897,Paperback,40,1988,2003,4.09,7261,15
0752866265,Hardcover,48,1968,2004,4.14,7259,36
0316324906,Hardcover,56,2015,2015,4.51,7238,0
0670876127,Hardcover,290,1948,1997,4.25,7237,49
0439634695,Paperback,32,1997,2003,4.4,7229,6
0723247749,Hardcover,58,1904,2002,4.1899999999999995,7226,98
0671493175,Board Book,14,1984,1984,4.119999999999999,7200,0
1596433426,Hardcover,160,2009,2009,4.1499999999999995,7189,0
0810984229,Hardcover,144,2010,2010,3.74,7162,0
0152928510,Hardcover,40,1995,1995,4.32,7155,0
0142407968,Paperback,127,1944,2007,3.79,7150,63
0060821094,Hardcover,80,2005,2005,3.87,7150,0
0307020975,Kindle Edition,24,1945,2010,4.159999999999999,7135,65
0375827781,Board Book,26,1963,2004,4.33,7113,41
1401211151,Paperback,176,2007,2007,3.68,7113,0
1596438738,Hardcover,80,2012,2014,4.13,7091,2
0879513918,Hardcover,226,1960,1990,4.2700000000000005,7085,30
0439490251,Hardcover,40,2004,2004,4.09,7074,0
0689863772,Hardcover,32,2004,2004,4.02,7070,0
0761130675,Board Book,24,2003,2003,4.26,7057,0
0152018840,Paperback,40,1994,1999,3.9,7043,5
0064440389,Paperback,64,1960,1983,4.1499999999999995,7036,23
0590189794,Hardcover,32,1999,1999,3.94,7030,0
1566192927,Hardcover,112,1999,1999,4.28,7023,0
0316382043,Hardcover,279,2018,2018,4.39,7007,0
0007169892,Paperback,36,1971,2003,3.97,7004,32
0761137998,Board Book,24,2005,2005,4.22,7000,0
1416908358,Paperback,32,1968,2005,4.04,6999,37
1594204780,Hardcover,127,2013,2013,4.1899999999999995,6978,0
0307986241,Hardcover,24,1961,2001,4.28,6974,40
0618756639,Hardcover,40,2010,2010,4.06,6945,0
1844583678,Board Book,32,2004,2007,4.2,6943,3
0316200638,Hardcover,40,2013,2013,4.17,6934,0
0399234446,Hardcover,32,1999,1999,4.2,6930,0
0152022724,Paperback,256,1957,2000,4.13,6905,43
0812428307,Hardcover,208,1928,1992,3.76,6902,64
0688143881,Paperback,32,1990,1995,4.28,6861,5
068984509X,Hardcover,40,2003,2003,4.24,6848,0
0723247714,Hardcover,58,1903,2002,4,6769,99
0811821315,Board Book,24,1991,1998,4.21,6767,7
0723257248,Hardcover,32,2005,2005,4.06,6758,0
081184658X,Hardcover,36,2005,2005,4.22,6755,0
0744507960,Hardcover,32,1988,1988,4.17,6753,0
0140548750,Hardcover,32,1982,1993,4.24,6738,11
0545528437,Paperback,176,2014,2014,4.09,6729,0
0375828990,Hardcover,32,1946,2004,4.17,6703,58
0152017666,Paperback,288,1960,1998,3.97,6701,38
0803734131,Hardcover,32,2012,2012,4.06,6696,0
1938298071,Hardcover,36,2014,2014,4.48,6689,0
1423109627,Hardcover,64,2008,2008,4.39,6689,0
0374325170,Hardcover,40,1997,1997,4.32,6680,0
1626721564,Paperback,232,2016,2016,4.1,6670,0
015201036X,Board Book,28,1989,1996,4.09,6612,7
1416985808,Hardcover,40,2009,2009,4.21,6586,0
068831662X,Paperback,192,1964,2000,3.9,6586,36
0152047336,Paperback,192,1959,2003,4.06,6585,44
1620103400,Hardcover,53,2014,2016,4.159999999999999,6570,2
0803731922,Hardcover,32,2007,2007,4.12,6564,0
0399247491,Hardcover,32,2006,2007,4.29,6546,1
0763634980,Paperback,32,1987,2007,4.14,6545,20
0374444587,Paperback,43,1864,1984,4.02,6545,120
076363266X,Hardcover,81,2010,2010,4.08,6544,0
0763672335,Hardcover,216,2016,2016,3.82,6520,0
0805003118,Paperback,48,1973,1987,4.11,6502,14
1891830627,Paperback,160,2004,2004,4.07,6436,0
0440866383,Paperback,144,1996,2006,3.87,6435,10
1449420435,Paperback,224,2011,2011,4.41,6434,0
0679875972,Hardcover,32,1996,1996,4.25,6430,0
0440405823,Paperback,128,1950,1992,4.02,6429,42
0770422470,Paperback,288,1933,1988,3.9,6418,55
0811834778,Hardcover,32,1812,2003,4.2700000000000005,6416,191
0810989867,Hardcover,246,2010,2010,4.159999999999999,6404,0
1596438657,Hardcover,144,2013,2013,3.84,6390,0
162672265X,Hardcover,208,2016,2016,4.109999999999999,6390,0
1449425666,Paperback,224,2012,2012,4.470000000000001,6375,0
3423707313,Paperback,160,1931,2002,4.18,6372,71
0061478679,Paperback,82,2008,2008,4.3,6326,0
1423106873,Hardcover,64,2007,2007,4.38,6321,0
0394800753,Hardcover,56,1949,1949,4.06,6306,0
0805071067,Hardcover,40,2005,2005,4.35,6298,0
0399224483,Hardcover,32,1888,1995,4.14,6279,107
0060256753,Hardcover,112,1963,2013,4.15,6271,50
1419700103,Hardcover,128,2012,2012,3.99,6271,0
0061235881,Hardcover,32,2008,2008,4.18,6269,0
0060542136,Hardcover,32,2007,2007,4.2,6260,0
1907704043,Paperback,24,2010,2010,4.24,6254,0
1587170051,Hardcover,32,2000,2000,4.29,6252,0
1484730887,Hardcover,44,2015,2015,4.42,6227,0
141697976X,Hardcover,40,2009,2009,4.21,6222,0
1584302674,Paperback,96,2010,2010,3.97,6208,0
0805083367,Hardcover,32,2007,2007,4.24,6206,0
0064410382,Paperback,272,1975,2001,4.08,6206,26
0811826023,Board Book,10,2000,2000,4.22,6204,0
1596438762,Paperback,240,2014,2014,4.31,6203,0
0439853117,Paperback,32,2005,2006,4.03,6186,1
1760150428,Paperback,144,2015,2015,4.119999999999999,6176,0
1423108191,Paperback,208,2005,2008,3.81,6169,3
0061960306,Hardcover,40,2010,2010,4.28,6167,0
1581170912,Board Book,20,2000,2006,4.07,6159,6
0590403605,Paperback,40,1986,2004,4.28,6142,18
1934287814,Paperback,164,2004,2010,4.2,6136,6
0064440346,Paperback,64,1975,1982,4.1899999999999995,6134,7
033398224X,Paperback,32,2003,2005,4.35,6127,2
0618756612,Hardcover,32,2013,2013,3.97,6124,0
0152007717,Board Book,32,1989,1996,4,6124,7
0375843892,Paperback,96,2011,2011,3.97,6110,0
1423109619,Hardcover,57,2008,2008,4.34,6107,0
0698116526,Paperback,32,1990,1998,4.109999999999999,6107,8
0803733631,Hardcover,160,2009,2009,3.96,6097,0
0399246525,Hardcover,32,2012,2012,4.42,6088,0
1423143434,Hardcover,64,2011,2011,4.45,6080,0
0688080510,Hardcover,40,1989,1989,4.319999999999999,6053,0
006125231X,Paperback,92,2007,2008,4.13,6019,1
0375858997,Hardcover,40,2010,2010,4.19,6007,0
0689810059,Paperback,40,1987,1996,4.109999999999999,6002,9
000171287X,Paperback,64,1971,1983,4.18,5999,12
0316007625,Hardcover,40,2010,2010,3.98,5995,0
076366961X,Hardcover,132,2015,2015,3.88,5982,0
0763690775,Hardcover,40,2016,2016,4.14,5965,0
0060001569,Hardcover,40,1996,2007,4.19,5962,11
0698115813,Paperback,32,1990,1997,4.37,5962,7
044843752X,Hardcover,196,1904,2004,3.84,5959,100
0374455031,Paperback,216,1989,1995,4.119999999999999,5959,6
0316015474,Hardcover,40,2009,2009,4.29,5948,0
0374330603,Hardcover,32,1986,1986,3.87,5906,0
0688132855,Paperback,48,1959,1996,4.15,5898,37
0761455264,Hardcover,40,2010,2010,4.22,5897,0
0545314798,Hardcover,224,2011,2011,3.98,5875,0
1589636147,Paperback,460,1911,2001,3.58,5875,90
1587171481,Paperback,48,1978,2002,4.34,5865,24
0007150342,Paperback,32,2004,2015,4.2,5851,11
0142402249,Paperback,208,1942,2006,3.98,5849,64
0763660507,Hardcover,294,2013,2013,3.91,5838,0
0399237178,Hardcover,32,2004,2004,4.21,5820,0
072324779X,Hardcover,58,1909,2002,4.18,5808,93
1419721372,Hardcover,32,2016,2016,4.49,5798,0
1416907866,Hardcover,58,2007,2007,4.21,5776,0
0763656003,Hardcover,56,2016,2016,4.25,5763,0
0060560711,Paperback,151,1993,2004,3.93,5738,11
0618381368,Hardcover,32,2002,2003,4.24,5735,1
0786837489,Hardcover,40,2006,2006,4.1,5708,0
0689862954,Paperback,102,2003,2004,4.09,5698,1
0440406935,Paperback,48,1977,1992,4.11,5686,15
1452110069,Hardcover,32,2013,2013,4.07,5669,0
1423164822,Hardcover,64,2012,2012,4.43,5669,0
0394826698,Paperback,32,1973,1973,4.13,5665,0
1564022803,Paperback,32,1992,1994,4.2,5660,2
158089061X,Paperback,32,2000,2000,4.36,5647,0
0152026142,Paperback,40,1990,2000,4.25,5640,10
1368003559,Hardcover,40,2018,2018,4.52,5636,0
1554537045,Hardcover,32,2014,2014,4.31,5629,0
0152056181,Paperback,240,1967,2006,3.71,5617,39
1596432357,Paperback,160,2011,2011,3.75,5604,0
0316107093,Paperback,96,1984,1984,4.4,5582,0
0997895829,Hardcover,212,2017,2017,4.41,5577,0
0545436796,Hardcover,56,2013,2013,4.26,5572,0
1932386343,Hardcover,296,2007,2009,4.23,5569,2
0689859414,Hardcover,142,2004,2005,4.35,5565,1
0307119378,Paperback,24,1985,1998,4.2700000000000005,5548,13
0689714335,Paperback,72,1930,1990,3.75,5540,60
0062252097,Hardcover,40,2015,2015,4.39,5536,0
0062860720,Hardcover,160,2018,2018,3.62,5536,0
1423119916,Hardcover,64,2010,2010,4.5,5535,0
0385388446,Hardcover,242,2015,2015,3.8,5531,0
0439921856,Paperback,32,1993,2007,3.89,5528,14
0316286125,Paperback,224,1963,1988,4.08,5526,25
1596431016,Paperback,208,2007,2007,3.97,5520,0
068811704X,Paperback,32,1977,1993,4.319999999999999,5518,16
0062438891,Hardcover,48,2017,2017,4.31,5517,0
0060838086,Hardcover,32,2009,2009,4.2,5504,0
1906332479,Paperback,144,2003,2009,4.18,5497,6
3407805330,Board Book,48,1978,2017,4.34,5492,39
0385386176,Hardcover,193,2015,2015,4.1499999999999995,5481,0
043990322X,Paperback,144,2008,2008,4.09,5467,0
0062484966,Paperback,224,2018,2018,4.05,5466,0
0688021174,Hardcover,40,1906,1983,4.26,5465,77
0140367063,Paperback,256,1899,1994,3.94,5454,95
0064401758,Paperback,176,1984,2019,3.84,5441,35
1416909052,Hardcover,40,1995,2006,4.01,5440,11
0786851759,Hardcover,48,2006,2006,4.35,5420,0
0688154727,Paperback,32,1988,1997,4.22,5416,9
068481353X,Hardcover,112,1995,1995,4.25,5404,0
0152626107,Paperback,32,1988,1992,4.12,5398,4
1596433973,Hardcover,36,2012,2012,4.04,5389,0
1423159527,Hardcover,32,2013,2013,4.11,5378,0
068982954X,Hardcover,44,1994,2001,4.15,5378,7
3522174402,Paperback,137,1966,2001,4.1899999999999995,5377,35
093729585X,Hardcover,62,1986,1990,4.03,5375,4
0061252336,Paperback,92,2008,2008,4.2,5368,0
0060526335,Paperback,32,1991,2004,4.41,5361,13
1524741728,Kindle Edition,32,2017,2017,4.41,5360,0
0152162801,Paperback,249,1956,2002,3.91,5360,46
0698113594,Paperback,32,1983,1996,4.19,5337,13
1869439260,Paperback,24,2009,2009,4.39,5306,0
0064440419,Paperback,64,1977,1983,4.2,5297,6
0151007152,Hardcover,72,1907,2002,4.2,5294,95
0670011614,Hardcover,40,2010,2010,4.15,5285,0
1416994157,Hardcover,64,2013,2013,4.12,5284,0
0671493183,Board Book,14,1984,1984,4.02,5283,0
0808551515,Hardcover,64,1940,1980,4.26,5279,40
0439241006,Hardcover,40,2003,2003,4.1,5275,0
061821612X,Paperback,32,1999,2002,4.37,5273,3
1423113470,Hardcover,57,2008,2008,4.4,5258,0
0439725224,Hardcover,40,1982,2005,4.26,5245,23
1599900769,Hardcover,144,2010,2010,3.89,5229,0
0823405656,Hardcover,48,1952,1985,4.1499999999999995,5228,33
014054285X,Paperback,32,1991,1994,4.17,5221,3
1302900056,Paperback,160,2015,2016,3.89,5217,1
031610731X,Hardcover,40,2010,2010,4.13,5212,0
0803706197,Hardcover,32,1989,1989,4.29,5208,0
9735057492,Paperback,48,2016,2017,4.14,5202,1
1481439782,Hardcover,48,2016,2016,4.15,5193,0
1524719374,Hardcover,288,2018,2018,4.159999999999999,5185,0
0345443829,Paperback,96,1980,2001,4.08,5167,21
1416991417,Hardcover,40,2010,2010,4.13,5165,0
0810990830,Paperback,192,1996,2002,4.34,5162,6
0763690457,Hardcover,80,2018,2018,4.48,5161,0
0375867562,Hardcover,32,2012,2012,4.06,5158,0
0689834349,Board Book,16,1977,2000,4.29,5150,23
1596432721,Hardcover,28,2007,2007,4.08,5146,0
0375825894,Hardcover,32,1956,2004,4.26,5145,48
1492662143,Kindle Edition,144,2017,2017,4.24,5140,0
1423133099,Hardcover,64,2011,2011,4.41,5135,0
0395746566,Hardcover,48,1999,1999,4.21,5115,0
0316363235,Hardcover,240,2018,2018,4.49,5114,0
0152518738,Hardcover,48,1943,1981,4.11,5109,38
1423178289,Hardcover,64,2016,2016,4.43,5098,0
159643239X,Paperback,268,2007,2008,4.06,5098,1
0399161031,Hardcover,36,2012,2012,4.13,5093,0
0395199727,Paperback,48,1972,1974,4.17,5089,2
1423113357,Hardcover,40,2008,2008,4.02,5072,0
0723247722,Hardcover,57,1903,2002,4.08,5046,99
0688099335,Paperback,40,1985,2004,4.08,5043,19
0486201813,Paperback,240,1865,1962,3.86,5039,97
1554533090,Hardcover,64,2009,2009,4.06,5017,0
0968876838,Hardcover,32,2001,2003,4.52,5007,2
0375935274,Hardcover,40,2010,2010,4.22,4987,0
0062368435,Hardcover,32,2015,2015,4.03,4971,0
0061547921,Paperback,82,2008,2008,4.109999999999999,4958,0
0752847740,Paperback,48,1981,2001,4.02,4952,20
0679811761,Paperback,192,1964,1991,4.04,4914,27
0803731957,Hardcover,32,2008,2008,4.1,4909,0
0972394648,Hardcover,32,2008,2008,4.41,4907,0
0395205034,Paperback,48,1972,1975,4.16,4881,3
061899923X,Hardcover,32,2008,2008,4.18,4874,0
076365079X,Hardcover,240,2013,2013,3.91,4871,0
1554533856,Hardcover,32,2007,2007,4.29,4854,0
0007202423,Hardcover,34,2005,2005,4.08,4826,0
1603090754,Paperback,186,2013,2013,4,4824,0
0763628077,Hardcover,56,2008,2008,4.29,4816,0
1894965108,Hardcover,32,2000,2004,4.33,4813,4
0062017810,Hardcover,30,2013,2013,3.86,4810,0
0333534085,Paperback,256,1922,1990,4.06,4810,68
015206057X,Hardcover,40,2008,2008,4.23,4796,0
144947960X,Paperback,232,2017,2017,4.31,4796,0
0547215673,Hardcover,32,2010,2010,4.06,4793,0
015205880X,Paperback,176,1993,2007,4.1899999999999995,4788,14
0061915130,Hardcover,40,2011,2011,4.11,4783,0
039480080X,Hardcover,58,1956,1956,3.93,4781,0
006200400X,Hardcover,72,2011,2011,4.08,4779,0
0060298480,Hardcover,40,2002,2002,3.95,4775,0
1566569478,Hardcover,32,2013,2013,4.28,4745,0
0394800834,Hardcover,64,1947,1947,4.07,4745,0
0689713533,Paperback,48,1964,1989,3.91,4742,25
1442451025,Kindle Edition,40,2014,2014,4.26,4740,0
141970396X,Hardcover,128,2012,2012,4.1499999999999995,4739,0
1423114108,Hardcover,64,2009,2009,4.33,4732,0
0553213679,Paperback,213,1913,1989,3.98,4706,76
1423174917,Hardcover,58,2013,2013,4.4,4705,0
0374370923,Hardcover,32,1998,1998,4.07,4697,0
1596437405,Hardcover,160,2011,2011,3.93,4696,0
0142407054,Paperback,240,2003,2006,3.85,4690,3
0061244058,Hardcover,32,2007,2007,4.03,4676,0
0670871923,Board Book,32,1981,1997,4.23,4660,16
1402779194,Hardcover,12,2007,2010,4.22,4642,3
1402747829,Hardcover,24,2007,2007,4.22,4639,0
0545637082,Hardcover,40,2015,2015,4.25,4634,0
1853261106,Paperback,300,1847,1993,3.84,4629,146
0545850029,Hardcover,224,2018,2018,4.31,4625,0
030711886X,Paperback,24,1982,1999,4.319999999999999,4616,17
0811856836,Hardcover,132,2007,2007,4.119999999999999,4607,0
037582538X,Hardcover,40,2004,2004,4.17,4606,0
0590442880,Paperback,32,1984,1984,4.25,4602,0
0805049002,Paperback,32,1990,1996,4.41,4601,6
0345320085,Paperback,128,1981,1999,4.06,4601,18
1423114116,Hardcover,64,2009,2009,4.37,4595,0
0803718756,Hardcover,16,1995,1996,4.27,4591,1
0140502017,Paperback,64,1957,1985,4.09,4589,28
0316070300,Hardcover,32,2011,2011,4.05,4586,0
1423103033,Paperback,152,2008,2008,3.98,4584,0
1596436255,Hardcover,77,2010,2010,3.96,4583,0
1596435577,Hardcover,96,2013,2013,4.01,4577,0
0152010289,Hardcover,50,1997,1997,4.21,4567,0
0689859856,Hardcover,40,2007,2007,4.27,4560,0
0802853854,Hardcover,42,2014,2014,4.27,4559,0
0439555051,Hardcover,208,1997,2003,3.9,4557,6
0395640512,Hardcover,32,1992,1992,4.26,4555,0
081091106X,Hardcover,32,2007,2007,4.45,4538,0
0399246533,Hardcover,32,2018,2018,4.53,4530,0
1416905278,Paperback,196,1993,2005,3.75,4530,12
0027379108,Hardcover,48,1948,1967,3.93,4518,19
0061173126,Hardcover,32,1987,2007,4.22,4516,20
0399254528,Hardcover,32,2010,2010,4.39,4511,0
0590189239,Hardcover,63,1999,1999,4.44,4511,0
068985658X,Board Book,32,2003,2003,4,4501,0
1423124847,Hardcover,32,2010,2010,4.25,4480,0
1328911128,Paperback,192,2019,2019,4.04,4478,0
0207170614,Hardcover,210,1918,1992,4.05,4477,74
1742611273,Paperback,348,2011,2012,4.3,4477,1
1524740918,Hardcover,40,2018,2018,4.26,4476,0
1419710540,Hardcover,40,2014,2014,4.36,4475,0
0395919088,Paperback,24,1998,1998,4.2700000000000005,4473,0
1582464502,Hardcover,32,2013,2013,4.42,4462,0
0698113608,Paperback,40,1988,1996,4.18,4457,8
1477847723,Hardcover,32,2014,2014,4.05,4454,0
1423143426,Hardcover,64,2011,2011,4.36,4451,0
039922419X,Hardcover,96,1939,1939,4.09,4442,0
0805070613,Hardcover,196,1942,2002,4.26,4439,60
0375846840,Paperback,96,2009,2009,4.1,4436,0
0688082947,Paperback,32,1947,1988,3.84,4435,41
1626720800,Hardcover,135,2015,2015,4.05,4428,0
0310212472,Hardcover,32,1997,1997,4.29,4424,0
1888963107,Hardcover,150,2000,2002,3.9,4414,2
0062275569,Hardcover,40,2013,2013,4.23,4413,0
0670060607,Hardcover,237,2006,2006,3.99,4409,0
0340565640,Paperback,24,1991,1991,4.109999999999999,4404,0
0395148065,Hardcover,88,1952,1952,4.04,4399,0
0749851821,Paperback,36,1971,2003,3.95,4393,32
0439199964,Hardcover,32,2002,2002,4.34,4392,0
1407106171,Hardcover,32,2008,2008,4.24,4385,0
1416917381,Hardcover,48,2006,2006,4.16,4379,0
0805089039,Hardcover,211,2010,2010,3.83,4378,0
1596436247,Hardcover,32,2012,2012,3.92,4366,0
0618636870,Paperback,32,1990,2005,3.77,4360,15
1328530825,Paperback,224,2019,2019,4.06,4360,0
0762417129,Hardcover,56,1995,2004,4.3,4351,9
1481469096,Hardcover,32,2017,2017,4.47,4349,0
0374466238,Paperback,32,1990,1993,3.79,4341,3
0761365877,Paperback,108,2012,2012,3.81,4340,0
1554531403,Hardcover,32,2007,2007,4.22,4336,0
0698114124,Paperback,32,1993,1996,4.14,4331,3
0394892178,Hardcover,48,1987,1987,4,4328,0
0689851243,Paperback,128,2000,2002,4.119999999999999,4327,2
0399245170,Hardcover,240,2007,2007,4.04,4325,0
0823440559,Hardcover,40,2018,2018,4.4,4316,0
0671882392,Hardcover,32,1995,1995,3.93,4311,0
0062006428,Hardcover,40,2011,2011,4.03,4292,0
1423113489,Hardcover,64,2009,2009,4.38,4282,0
0333631986,Paperback,26,1980,1999,4.2700000000000005,4282,19
0525479015,Hardcover,32,2010,2010,4.14,4273,0
0547315813,Hardcover,38,2011,2011,3.89,4272,0
3499212803,Paperback,168,1979,2004,4.05,4272,25
0439490294,Hardcover,32,2008,2008,4.04,4264,0
0805013156,Paperback,32,1970,1990,4,4255,20
0553524267,Hardcover,48,2015,2015,3.8,4246,0
3522176103,Paperback,128,1962,2003,4.1899999999999995,4240,41
1894937805,Hardcover,95,1977,2006,4.35,4237,29
069811986X,Paperback,32,1994,2003,4.109999999999999,4234,9
1405206349,Paperback,44,1973,2002,3.52,4228,29
0375836047,Hardcover,116,2006,2006,3.94,4224,0
142319957X,Hardcover,64,2014,2014,4.45,4207,0
1416948295,Paperback,117,1967,2007,3.79,4202,40
0375860940,Paperback,96,2009,2009,4.18,4200,0
0805070621,Hardcover,260,1944,2002,4.24,4198,58
0525420649,Hardcover,377,2008,2008,4.02,4182,0
1620105292,Hardcover,96,2018,2018,4.14,4181,0
0374347018,Hardcover,56,2007,2007,4.07,4178,0
0062110632,Hardcover,34,2012,2012,4.17,4177,0
0803703740,Hardcover,32,1987,1987,4.14,4160,0
0140502874,Paperback,64,1940,1978,4.13,4158,38
0316226149,Hardcover,40,2015,2015,4.16,4153,0
0375812121,Hardcover,26,1970,2002,4.04,4148,32
1943200009,Hardcover,36,2016,2016,4.37,4139,0
0316070297,Hardcover,40,2014,2014,4.15,4131,0
0061688657,Kindle Edition,112,2009,2015,4.2700000000000005,4126,6
0062866001,Hardcover,36,2019,2019,4.17,4105,0
0439851475,Hardcover,32,2007,2007,4.05,4100,0
0899194974,Hardcover,32,1989,1989,4.25,4094,0
0140367527,Paperback,292,1906,1996,3.98,4091,90
1608868982,Paperback,112,2016,2016,3.95,4090,0
1562470779,Paperback,88,1993,1993,4.06,4086,0
0805003150,Paperback,48,1966,1971,3.93,4084,5
0316013722,Hardcover,40,2016,2016,4.2,4082,0
1423106857,Hardcover,40,2009,2009,4.25,4077,0
0805059830,Paperback,32,1993,1998,3.94,4064,5
0439269679,Hardcover,40,2002,2002,4.33,4047,0
0670012327,Hardcover,40,2011,2011,4.26,4046,0
0399252487,Hardcover,40,2009,2009,4.12,4036,0
0440417996,Paperback,40,2001,2003,4.35,4033,2
098596524X,Paperback,122,2013,2013,4.109999999999999,4033,0
0440471478,Paperback,224,1964,1987,4.159999999999999,4033,23
1423171012,Hardcover,40,2013,2013,4.07,4013,0
0374343888,Hardcover,40,1995,1995,4.33,4010,0
1407134507,Paperback,307,2011,2012,4.49,3994,1
1484767608,Hardcover,34,2018,2018,4.38,3989,0
0698115724,Paperback,32,1989,2001,4.23,3988,12
0060783338,Hardcover,32,2008,2008,4.08,3961,0
076369603X,Hardcover,46,2017,2017,3.83,3948,0
0670888168,Hardcover,316,1939,2001,4.35,3943,62
0811867846,Hardcover,44,2011,2011,4.1,3932,0
1416942068,Hardcover,32,2010,2010,4.01,3932,0
0152336796,Paperback,32,1987,1992,4.31,3932,5
0517205793,Hardcover,224,1902,1999,3.92,3928,97
1423183053,Hardcover,64,2013,2013,4.41,3922,0
077103475X,Paperback,352,1947,2001,3.86,3920,54
0316362387,Hardcover,44,2018,2018,4.37,3915,0
014240456X,Paperback,32,2003,2005,4.31,3911,2
0763665959,Hardcover,32,2014,2014,4.37,3903,0
1596437456,Hardcover,32,2012,2012,4.05,3897,0
1416917055,Paperback,32,1998,2007,4.1,3883,9
1587171201,Hardcover,32,2002,2002,4.33,3882,0
2012011411,Paperback,40,1857,2016,3.91,3880,159
006026683X,Hardcover,32,2011,2011,3.95,3873,0
0747541558,Hardcover,32,1957,1998,4.42,3867,41
0020436203,Paperback,32,1971,1974,3.85,3866,3
0810984237,Hardcover,80,2010,2010,3.92,3865,0
0968876889,Hardcover,32,1998,2003,4.3,3863,5
1590171012,Hardcover,169,1918,2004,3.95,3861,86
1421523272,Paperback,200,2000,2008,4.26,3857,8
0810993465,Hardcover,32,2007,2007,4.2,3855,0
0688147380,Paperback,32,1987,1996,4.24,3852,9
015202638X,Board Book,16,1991,2000,4.08,3849,9
0375870237,Hardcover,32,2014,2014,4,3844,0
054545347X,Paperback,238,2014,2014,4.05,3843,0
0345518543,Paperback,144,2010,2010,4.4,3842,0
0679804056,Paperback,32,1984,1984,4.22,3821,0
0061123250,Hardcover,32,2007,2007,4.19,3820,0
4063376648,Paperback,130,2009,2009,4.14,3817,0
0786808322,Hardcover,88,2008,2008,4.24,3817,0
0670062197,Hardcover,32,1958,2006,4.22,3814,48
0061547948,Paperback,86,2009,2009,4.1499999999999995,3814,0
073522935X,Hardcover,32,2018,2018,4.51,3813,0
0060286857,Hardcover,40,1999,2000,3.99,3798,1
1858815940,Hardcover,193,1961,1997,3.99,3797,36
0140503013,Paperback,29,1977,1999,4.22,3792,22
0140566228,Paperback,40,1994,1999,4.24,3788,5
0689815158,Paperback,224,1993,1997,4.04,3788,4
1931016070,Paperback,40,1973,2001,4.23,3770,28
1442422491,Hardcover,40,2011,2011,4.1,3768,0
1581342764,Hardcover,31,2001,2001,4.52,3753,0
159017125X,Hardcover,154,1967,2005,4.38,3750,38
1596433663,Paperback,160,2010,2010,3.67,3747,0
0399167897,Hardcover,42,2017,2017,4.52,3734,0
006154793X,Paperback,86,2008,2009,4.109999999999999,3733,1
1909263060,Hardcover,44,2013,2013,4.25,3730,0
0811872351,Hardcover,56,2013,2013,4.22,3727,0
0375867295,Paperback,96,2010,2010,4.21,3722,0
1405004770,Paperback,32,1993,2004,4.18,3721,11
0763631604,Hardcover,64,2006,2006,4.37,3711,0
0061235903,Hardcover,32,2009,2011,4.2,3708,2
0385327218,Hardcover,32,1963,2000,4.36,3708,37
1442414030,Hardcover,40,2012,2012,4.18,3704,0
1452137358,Hardcover,32,2014,2014,4.35,3700,0
1423154045,Hardcover,64,2012,2012,4.32,3700,0
0618428585,Hardcover,32,2004,2004,3.98,3687,0
039527804X,Hardcover,32,1979,1979,4.04,3687,0
0679891153,Hardcover,48,1999,1999,4.3,3684,0
0670806668,Hardcover,32,1956,1985,4.17,3682,29
0307978486,Hardcover,32,2014,2014,4.15,3681,0
0395726182,Hardcover,32,1996,1996,3.73,3659,0
0395664152,Paperback,32,1991,1993,4.29,3634,2
078948191X,Paperback,32,1998,2001,4.21,3623,3
0395257840,Hardcover,80,1977,1977,4.21,3619,0
0439020816,Hardcover,29,2007,2007,4.1,3617,0
1250076366,Hardcover,32,2017,2017,4.17,3612,0
0671493191,Board Book,14,1984,1984,4.01,3609,0
0440418291,Paperback,176,2000,2002,3.93,3609,2
0802723349,Hardcover,32,2011,2011,4.23,3600,0
1423160657,Hardcover,32,2013,2013,4.19,3598,0
0763636185,Hardcover,208,2009,2009,3.73,3595,0
0679887768,Hardcover,48,1973,1997,4.3,3594,24
069811373X,Paperback,32,1982,1996,4.08,3594,14
0140365990,Paperback,224,1984,1994,4.06,3593,10
0152060200,Hardcover,32,2008,2008,3.9,3588,0
0374409277,Paperback,32,1986,1988,4.19,3576,2
0670062871,Hardcover,40,2010,2010,4.03,3562,0
0786848936,Hardcover,40,2006,2006,4.21,3557,0
1608869938,Paperback,112,2017,2017,3.97,3553,0
0590222953,Paperback,32,1995,1995,4.34,3549,0
1423107969,Hardcover,40,2012,2012,4.17,3545,0
1416985816,Hardcover,40,2009,2009,4.08,3545,0
0670856312,Hardcover,32,1995,1995,4.07,3545,0
076115728X,Hardcover,28,2010,2010,4.55,3537,0
082340093X,Hardcover,58,1898,1938,3.96,3536,40
1590172213,Hardcover,190,1969,2007,4.08,3533,38
0062667122,Hardcover,32,2018,2018,4.25,3530,0
0152063897,Hardcover,40,2009,2009,4.23,3514,0
1627790713,Hardcover,32,2014,2014,4.2,3512,0
1550374842,Paperback,24,1996,1996,4.27,3512,0
1452126992,Hardcover,34,2015,2015,4.38,3508,0
0553280465,Paperback,274,1925,1989,3.76,3491,64
1742612377,Paperback,352,2013,2013,4.29,3488,0
0064440451,Paperback,64,1970,1983,4.21,3485,13
1419714651,Hardcover,40,2015,2015,4.26,3483,0
0763634999,Paperback,32,1988,2007,4.22,3479,19
031631966X,Ebook,32,2017,2017,4.54,3477,0
0316020338,Hardcover,64,1991,2001,4.48,3474,10
0618176748,Hardcover,32,2002,2002,4.18,3469,0
0375858601,Hardcover,32,2015,2015,4.12,3468,0
0140547533,Paperback,40,1972,1993,3.95,3466,21
1423113349,Hardcover,48,2012,2012,4.03,3462,0
0547641028,Hardcover,40,2012,2012,4.08,3461,0
1481465597,Hardcover,40,2016,2016,4.61,3460,0
0723247803,Hardcover,58,1910,2002,3.96,3453,92
0152579958,Hardcover,40,1991,1991,4.17,3453,0
0689867476,Hardcover,64,2006,2006,3.86,3453,0
0064431851,Paperback,40,1981,1989,3.9,3447,8
0394800257,Hardcover,72,1962,1962,4.24,3447,0
0440455332,Paperback,137,1971,1972,4.21,3446,1
1619633744,Hardcover,256,2015,2015,4.08,3441,0
0375832300,Paperback,96,2005,2005,4.03,3438,0
0316155624,Hardcover,32,2004,2004,4.37,3434,0
0140565817,Paperback,32,1980,1999,4.24,3431,19
0140569898,Hardcover,34,2004,2006,4.05,3429,2
0689708076,Paperback,32,1970,1988,4.11,3427,18
1406342327,Hardcover,48,2014,2014,4.13,3426,0
1419708562,Hardcover,128,2013,2013,4.1499999999999995,3420,0
1101935863,Hardcover,248,2017,2017,4.07,3415,0
1416964843,Hardcover,96,2009,2009,3.97,3412,0
1596434341,Paperback,77,2012,2012,4.17,3410,0
0802787649,Hardcover,288,1970,2001,3.95,3406,31
0590433504,Paperback,32,1980,1989,4.13,3404,9
0920303331,Paperback,24,1985,1985,4.09,3400,0
0307168034,Hardcover,48,1992,2000,4.24,3397,8
067006100X,Hardcover,32,2006,2006,4.35,3396,0
0689847122,Board Book,16,2003,2003,4.1,3389,0
1785062859,Paperback,208,1950,2015,4.18,3389,65
0911903968,Paperback,266,1996,2005,4.67,3389,9
1338180614,Hardcover,192,2018,2018,3.93,3384,0
0375867120,Hardcover,40,2013,2013,4.09,3384,0
0679820647,Hardcover,136,1974,1993,4.37,3383,19
0803730802,Hardcover,160,2006,2006,3.73,3380,0
0439079462,Paperback,32,1995,1999,4.19,3378,4
1423119908,Hardcover,64,2010,2010,4.31,3373,0
0393058484,Hardcover,462,2004,2004,4.46,3370,0
0399247807,Hardcover,183,2008,2008,4.119999999999999,3370,0
0140328580,Paperback,160,1952,1988,3.97,3368,36
1416939997,Hardcover,32,2006,2007,3.98,3367,1
1442450274,Hardcover,40,2012,2012,4.22,3366,0
0140557741,Paperback,64,1995,1998,4.3,3366,3
1596434325,Paperback,77,2010,2010,4.14,3366,0
1442446730,Hardcover,32,2013,2013,4.11,3365,0
0060287675,Hardcover,32,1991,2000,3.94,3364,9
1563054418,Board Book,24,1993,1993,4.13,3349,0
1479597465,Hardcover,32,2017,2017,4.27,3335,0
0531071391,Paperback,32,1996,1999,4.01,3334,3
0979974623,Hardcover,32,2009,2009,4.3,3326,0
0735227926,Hardcover,56,2017,2017,4.22,3321,0
0375945571,Hardcover,40,2012,2012,3.97,3309,0
081091641X,Hardcover,24,1989,2007,4.1899999999999995,3307,18
0545160936,Hardcover,215,2010,2010,3.74,3306,0
0394800478,Hardcover,72,1967,1967,4.22,3304,0
061335933X,Hardcover,32,1994,2002,4.1,3303,8
0763650226,Hardcover,32,2010,2010,4.18,3298,0
0140380736,Paperback,272,1995,1998,3.89,3298,3
1419703986,Hardcover,128,2012,2012,3.87,3293,0
3791530151,Hardcover,176,1933,2006,4.1899999999999995,3292,73
0439918170,Paperback,32,1994,2007,4.02,3290,13
0062051571,Hardcover,32,1998,1998,4.04,3285,0
1585365076,Hardcover,32,2010,2010,4.36,3281,0
0061804428,Hardcover,32,2013,2013,4.2,3267,0
1596432799,Paperback,160,2010,2010,3.54,3262,0
1584854235,Paperback,70,2002,2002,3.93,3261,0
1626724415,Hardcover,40,2016,2016,4.21,3260,0
1407138456,Kindle Edition,240,2013,2013,4.53,3255,0
0307655393,Hardcover,92,1965,1965,4.26,3249,0
0545865026,Hardcover,40,2018,2018,4.33,3247,0
0399255141,Hardcover,32,2012,2012,4.23,3247,0
0062274457,Hardcover,40,2013,2013,4.26,3245,0
0545312833,Paperback,126,2012,2012,4.14,3245,0
0671449036,Board Book,16,1982,1982,3.96,3230,0
0375839275,Board Book,26,1952,2007,4.4,3227,55
0140562478,Paperback,32,1996,1998,4.18,3220,2
1572842245,Hardcover,32,2017,2017,4.37,3219,0
3522149904,Hardcover,276,1962,1990,4.319999999999999,3218,28
1561454907,Hardcover,36,2009,2009,4.31,3215,0
0007263856,Paperback,40,2010,2015,4.17,3213,5
0765374692,Hardcover,208,2015,2015,4.38,3208,0
0698118308,Paperback,32,1996,2001,3.96,3208,5
1407134515,Paperback,272,2013,2013,4.48,3199,0
1444908898,Hardcover,48,2013,2014,4.09,3196,1
1452162816,Hardcover,104,2017,2017,4.29,3192,0
0316522864,Hardcover,256,2019,2019,4.04,3191,0
0786836504,Hardcover,12,2005,2005,4.14,3189,0
0152938222,Hardcover,82,1981,1981,3.65,3188,0
0312549660,Hardcover,32,2010,2010,4.58,3187,0
081186023X,Hardcover,36,2007,2007,4.09,3186,0
0688149014,Board Book,16,1983,1996,3.87,3186,13
0763636193,Hardcover,240,2011,2011,3.86,3185,0
054731583X,Hardcover,40,2011,2011,4.08,3184,0
1891830643,Paperback,125,2005,2005,4.17,3184,0
0525479651,Hardcover,32,2009,2009,4.2,3181,0
0689852819,Hardcover,128,2006,2007,3.79,3180,1
1423101006,Hardcover,191,2007,2007,3.87,3172,0
1554984319,Hardcover,32,2015,2015,4.27,3171,0
0385376715,Hardcover,36,2015,2015,4.39,3169,0
0399167919,Hardcover,112,2014,2014,4.28,3167,0
0750028688,Hardcover,32,1986,1986,4.14,3166,0
1583940537,Hardcover,32,2001,2001,3.9,3146,0
0333963962,Paperback,32,2002,2003,4.18,3144,1
0385265204,Paperback,368,1980,1997,4.26,3138,17
1596439645,Hardcover,40,2016,2016,4.19,3136,0
0803739834,Hardcover,250,2015,2015,4.109999999999999,3131,0
0822567644,Hardcover,40,2009,2009,4.03,3128,0
0439309107,Hardcover,56,1999,2001,4.49,3127,2
1405050578,Hardcover,176,2007,2007,4.08,3125,0
0152024409,Paperback,38,1997,2000,4.41,3125,3
0735229864,Hardcover,48,2018,2018,4.46,3124,0
1442459352,Hardcover,40,2014,2014,4.14,3117,0
0688162959,Paperback,32,1994,1998,4.16,3117,4
1841481645,Hardcover,48,1838,2005,4.25,3116,167
0061688665,Kindle Edition,112,2010,2015,4.24,3114,5
0316213888,Hardcover,40,2016,2016,4.17,3111,0
0679885404,Hardcover,32,1997,1997,4.2,3110,0
0061552054,Hardcover,32,2008,2008,4.01,3106,0
1909263184,Hardcover,64,2014,2014,4.4,3106,0
0399247815,Hardcover,160,2009,2009,4.09,3106,0
080507063X,Hardcover,224,1951,2002,3.96,3106,51
0060242302,Hardcover,64,1959,1987,4.3,3105,28
1599903962,Paperback,160,2009,2009,4.109999999999999,3099,0
9129583144,Hardcover,52,1985,1987,4.1499999999999995,3097,2
0689712014,Paperback,36,1970,1988,3.99,3096,18
0060579080,Hardcover,40,2009,2009,3.97,3088,0
0375839011,Hardcover,40,1956,2006,4.2,3088,50
0382092112,Hardcover,32,1984,1986,4.21,3087,2
0007182325,Paperback,32,2008,2017,4.13,3084,9
0744531667,Hardcover,44,1845,1994,4.25,3083,149
0061783749,Hardcover,40,2012,2013,4.29,3079,1
0064430871,Paperback,44,1958,1982,3.81,3077,24
0698117913,Paperback,32,1992,1999,4.13,3075,7
0545143144,Hardcover,40,2009,2009,4.12,3074,0
1442402989,Hardcover,48,2017,2017,4.28,3071,0
1416938931,Hardcover,48,2011,2011,4.09,3069,0
0670012335,Hardcover,40,2012,2012,4.26,3065,0
0545399971,Hardcover,40,2012,2012,4.3,3056,0
0064408582,Paperback,304,1950,2000,4.24,3055,50
0374317763,Hardcover,128,2008,2008,3.97,3050,0
0062086944,Paperback,224,2012,2012,4.45,3046,0
1934287911,Paperback,144,2006,2010,4.359999999999999,3042,4
1407138871,Hardcover,272,2014,2014,4.48,3040,0
0525465286,Hardcover,32,2001,2001,4.18,3034,0
0399245340,Hardcover,32,2008,2008,4.06,3033,0
0375843906,Paperback,96,2011,2011,4.1499999999999995,3031,0
1442430419,Hardcover,56,2010,2011,4.29,3024,1
0307978966,Hardcover,40,2013,2013,4.26,3022,0
0517709775,Board Book,32,1983,1997,4.28,3021,14
9681646193,Hardcover,30,1993,1995,4.18,3020,2
0395673461,Hardcover,32,1993,1993,4.19,3020,0
0399237496,Hardcover,48,2005,2005,4.23,3014,0
081185924X,Hardcover,40,2008,2008,4.24,3013,0
1594450331,Hardcover,26,2005,2005,4.1,3013,0
0486436489,Paperback,176,1899,2004,3.88,3000,105
0375846824,Hardcover,32,2006,2010,4.19,2999,4
1561636126,Paperback,128,2008,2011,4.29,2993,3
1328780961,Hardcover,40,2019,2019,4.7,2988,0
0689844611,Paperback,176,1999,2001,3.93,2981,2
0763693553,Hardcover,32,2018,2018,4.39,2980,0
0553513370,Hardcover,32,2016,2016,4.11,2979,0
037598772X,Ebook,40,1973,2012,4.46,2978,39
080501635X,Hardcover,32,1991,1991,4.05,2972,0
159643600X,Hardcover,103,2011,2011,4.06,2972,0
0395486688,Hardcover,32,1988,1988,4.07,2971,0
0689869223,Hardcover,40,2007,2007,4.14,2967,0
0397322593,Hardcover,40,1989,1989,3.97,2965,0
0547773579,Hardcover,40,2013,2013,4.23,2950,0
054403256X,Hardcover,40,2015,2015,4.13,2947,0
015202493X,Paperback,304,1959,2000,3.96,2947,41
0805087761,Hardcover,40,2011,2011,4.13,2946,0
0525478841,Hardcover,32,2007,2007,4.159999999999999,2943,0
1484716302,Hardcover,64,2015,2015,4.35,2931,0
0547014945,Hardcover,32,2009,2009,3.99,2923,0
0689801297,Paperback,32,1992,1995,4.25,2922,3
1421500493,Hardcover,256,2004,2005,4.51,2922,1
0394822862,Paperback,36,1971,1971,4.14,2909,0
1452109206,Hardcover,40,2013,2013,4.15,2908,0
0670012955,Hardcover,32,2011,2011,4,2908,0
0141332697,Hardcover,224,1928,2001,4.13,2908,73
0140558772,Paperback,32,1988,1996,4.31,2907,8
1909263990,Hardcover,48,2016,2016,4.34,2903,0
0689859864,Hardcover,40,2008,2008,4.23,2900,0
0786836512,Board Book,12,2005,2005,4.06,2898,0
0061715174,Hardcover,40,2010,2010,3.95,2895,0
0439395453,Hardcover,32,2003,2003,4.17,2888,0
0395423317,Hardcover,32,1986,1986,4.09,2887,0
1338298399,Hardcover,32,2018,2019,4.18,2886,1
0061688673,Kindle Edition,112,2010,2015,4.2700000000000005,2886,5
1582461481,Paperback,32,1991,2005,4.35,2879,14
1626721599,Hardcover,240,2017,2017,4.18,2876,0
1596433698,Paperback,112,2009,2009,4.1499999999999995,2876,0
0142500607,Paperback,32,1996,2003,4.28,2872,7
0156181924,Paperback,48,1978,1978,4.23,2870,0
0062399616,Ebook,40,1995,1995,3.66,2867,0
1419715364,Hardcover,128,2015,2015,4.39,2867,0
1405210117,Paperback,400,1935,2008,3.95,2867,73
0679886478,Hardcover,320,1998,1998,4.44,2854,0
0060511052,Paperback,64,1981,2004,4.17,2850,23
1847807178,Hardcover,40,2015,2015,4.26,2847,0
059093998X,Hardcover,40,1997,1997,4.3,2847,0
1452125325,Hardcover,40,2015,2015,4.2,2845,0
0142403997,Paperback,32,2003,2005,4.27,2843,2
0375832319,Paperback,96,2006,2006,4.13,2839,0
0152661972,Hardcover,40,1991,1991,4,2837,0
0698118367,Paperback,32,1973,2000,4.319999999999999,2836,27
069401270X,Board Book,24,2019,2019,4.29,2835,0
0152060308,Paperback,32,1997,2006,4.18,2834,9
9029540052,Hardcover,368,1963,1977,4.1499999999999995,2833,14
0544102290,Hardcover,42,2015,2015,4.24,2830,0
1550372564,Paperback,32,1992,1992,4.24,2828,0
1884734715,Hardcover,32,2000,2000,4.26,2825,0
1554535026,Hardcover,64,2010,2010,4.1,2821,0
1368019013,Hardcover,40,2019,2019,4.27,2816,0
0744547792,Paperback,33,1992,2005,3.97,2812,13
0763665304,Hardcover,48,2016,2016,4.03,2809,0
1626723710,Hardcover,40,2017,2017,4.24,2806,0
0810945681,Hardcover,32,2001,2001,4.26,2806,0
1405089490,Hardcover,32,2007,2007,3.95,2805,0
0399214011,Hardcover,32,1986,1986,4.319999999999999,2803,0
0061574287,Hardcover,40,2008,2008,4.01,2799,0
0439866650,Paperback,157,1970,1998,4.1899999999999995,2797,28
0545788927,Hardcover,32,2014,2014,3.89,2792,0
0061244082,Hardcover,32,2009,2009,3.82,2789,0
1596433078,Hardcover,48,2013,2013,4.18,2788,0
0763618136,Hardcover,40,1983,2002,4.17,2788,19
0689716087,Paperback,56,1936,1992,4.24,2779,56
0547007035,Hardcover,32,2008,2008,4.19,2776,0
037597038X,Hardcover,40,2013,2013,3.93,2774,0
0803732287,Hardcover,26,2000,2008,4.25,2772,8
9351039714,Kindle Edition,272,2015,2015,4.470000000000001,2771,0
0763610526,Paperback,40,1999,2002,4.26,2766,3
0142408476,Paperback,32,2002,2007,3.96,2763,5
0439700493,Hardcover,32,2011,2011,3.94,2762,0
0385370032,Paperback,133,2014,2014,4.159999999999999,2762,0
0374351147,Hardcover,29,2003,2003,4.2,2761,0
1442422475,Hardcover,32,2012,2012,3.98,2759,0
0805059520,Hardcover,32,2000,2000,3.97,2746,0
0752866400,Paperback,56,2003,2004,3.77,2746,1
0763624993,Hardcover,40,2007,2012,4.47,2745,5
006054063X,Paperback,32,1999,2003,4.22,2741,4
0375862234,Hardcover,24,2007,2009,4.07,2740,2
1416909680,Paperback,32,2002,2002,4.06,2740,0
0763678384,Hardcover,32,2017,2017,4.32,2739,0
0375972064,Hardcover,48,2014,2014,4.03,2734,0
0698118553,Paperback,96,1989,1999,4.1899999999999995,2733,10
006056072X,Paperback,192,1994,2004,3.91,2728,10
1596438665,Hardcover,32,2014,2014,4.24,2725,0
1423179587,Hardcover,60,2014,2014,4.37,2720,0
0152054456,Hardcover,32,2005,2005,4.17,2715,0
190345879X,Hardcover,22,1984,2007,4.37,2714,23
1452131562,Hardcover,52,2015,2015,3.9,2702,0
0060598484,Hardcover,32,2005,2005,4.09,2702,0
1934287857,Paperback,155,2005,2010,4.319999999999999,2698,5
0394827996,Paperback,32,1970,1974,4.08,2696,4
0375864490,Hardcover,32,2010,2010,4.02,2695,0
0316199990,Hardcover,40,2016,2016,3.97,2691,0
0007175159,Hardcover,59,1965,2004,4.21,2689,39
0439649501,Board Book,12,2004,2004,4.03,2689,0
068987829X,Paperback,32,2001,2005,4.46,2686,4
0140565957,Paperback,32,1997,2002,4.1,2685,5
0525553363,Hardcover,32,2019,2019,4.54,2681,0
1442497440,Hardcover,32,2014,2014,4.2,2676,0
0316359408,Hardcover,192,1990,1994,4.14,2676,4
0307010309,Hardcover,24,1977,1997,4.29,2675,20
1423145623,Hardcover,32,2011,2012,4.12,2672,1
0763632651,Hardcover,74,2008,2008,4.18,2672,0
1101919191,Paperback,64,2017,2018,4.31,2667,1
0152065334,Hardcover,40,2008,2008,4.14,2665,0
015202610X,Paperback,240,1960,2000,4.07,2664,40
0439490278,Hardcover,40,2006,2006,4.06,2657,0
1596436034,Hardcover,32,2014,2014,3.82,2649,0
1484722620,Hardcover,64,2015,2015,4.37,2647,0
0062304348,Hardcover,40,2016,2016,4.24,2641,0
0810932377,Hardcover,32,1996,1996,4.1499999999999995,2640,0
015201909X,Hardcover,40,1999,1999,4.13,2637,0
0374460310,Paperback,32,1998,2005,4.03,2634,7
0060099453,Paperback,64,1986,2002,4.29,2632,16
1442423641,Hardcover,40,2011,2011,4.15,2617,0
0689824491,Paperback,224,1996,1999,3.98,2615,3
1442401672,Hardcover,32,2010,2010,4.04,2610,0
0375970355,Hardcover,96,2012,2012,4.26,2608,0
1419703951,Hardcover,128,2012,2012,4.39,2604,0
0764937103,Hardcover,32,1994,2006,4.23,2596,12
1442414022,Hardcover,32,2013,2013,4.19,2594,0
1596438231,Hardcover,128,2013,2013,3.9,2593,0
054556543X,Paperback,316,2015,2015,3.82,2589,0
037593989X,Hardcover,96,2007,2007,4.2,2587,0
125007181X,Board Book,34,2015,2015,3.51,2583,0
1452101108,Hardcover,40,2012,2012,4.04,2580,0
0385746407,Hardcover,48,1946,2003,3.76,2577,57
076363090X,Hardcover,40,2009,2009,4.41,2574,0
084313819X,Paperback,32,1974,1995,4.1899999999999995,2573,21
0698115678,Paperback,32,1993,1997,4.2,2568,4
0060846216,Hardcover,336,2007,2007,3.53,2567,0
0439551900,Paperback,54,1989,2006,4.119999999999999,2565,17
037586590X,Paperback,216,2012,2013,3.32,2562,1
0545098939,Paperback,96,2010,2010,4.06,2562,0
0545637546,Hardcover,32,2016,2016,4.11,2561,0
0823411311,Paperback,30,1989,1994,4.2700000000000005,2558,5
0811869253,Hardcover,36,2012,2012,4.11,2556,0
0374334994,Hardcover,32,2008,2008,4.03,2553,0
1563054442,Board Book,24,1993,1993,4.13,2553,0
0062298895,Hardcover,32,2015,2015,4.24,2552,0
0698113888,Paperback,32,1982,1996,4.06,2550,14
0099432447,Paperback,32,1969,2002,4.24,2545,33
0395729521,Paperback,32,1992,1995,4.08,2541,3
0544252306,Hardcover,40,2014,2014,4.35,2540,0
0688162673,Hardcover,40,1955,2002,4.29,2535,47
0395533082,Hardcover,48,1990,1990,4.06,2533,0
1596437316,Hardcover,32,2013,2013,3.97,2531,0
1481416472,Hardcover,32,2015,2015,4.33,2527,0
0439669375,Paperback,32,1990,2004,4.13,2525,14
0062060945,Hardcover,224,2011,2011,4.39,2525,0
006228620X,Hardcover,32,2014,2014,4.08,2524,0
0590472801,Hardcover,32,1989,1993,4.41,2524,4
0140566473,Paperback,48,1958,2000,4.119999999999999,2523,42
1407115561,Hardcover,32,2010,2010,4.24,2522,0
0590445103,Paperback,32,1977,1993,4.38,2519,16
0763655465,Hardcover,32,2012,2012,4.06,2518,0
141692518X,Hardcover,32,2004,2006,4.319999999999999,2511,2
0316119202,Paperback,188,1956,1993,3.9,2511,37
1626722668,Paperback,208,2017,2017,4.26,2506,0
0061236276,Hardcover,40,2009,2009,4.17,2505,0
0385378661,Hardcover,32,2015,2015,4.06,2504,0
0811867838,Hardcover,40,2012,2013,4.1,2504,1
1402290829,Hardcover,32,2013,2013,4.25,2503,0
0062245341,Ebook,256,2013,2013,4.52,2501,0
0763665290,Hardcover,40,2015,2015,4.1,2499,0
0241253586,Hardcover,112,2017,2017,4.56,2496,0
8426403433,Hardcover,149,2016,2016,4.48,2492,0
068810990X,Paperback,32,1991,1991,3.94,2491,0
0027351904,Hardcover,32,1944,1968,3.94,2489,24
0061920886,Hardcover,32,2011,2011,4.02,2487,0
1932416870,Hardcover,48,2007,2007,4.13,2487,0
1608864871,Paperback,128,2015,2015,3.78,2486,0
0786847654,Hardcover,140,2006,2006,4.28,2485,0
0689878257,Paperback,48,1963,2005,4.24,2483,42
0618253963,Hardcover,32,2002,2002,3.79,2483,0
0061915106,Hardcover,32,2009,2009,4.03,2477,0
0679880836,Paperback,40,1994,1996,4.23,2476,2
0375860959,Paperback,96,2010,2010,4.18,2475,0
0763634409,Hardcover,40,2009,2009,4.1,2474,0
8426155596,Hardcover,176,1960,1993,4.2700000000000005,2468,33
0590429892,Hardcover,384,1988,1988,4.34,2465,0
0805079513,Hardcover,32,2006,2006,4.09,2463,0
0152022635,Hardcover,224,1961,2000,4.17,2453,39
0380790866,Paperback,128,1988,2005,3.83,2451,17
039916085X,Hardcover,32,2014,2014,4.23,2450,0
0891079920,Hardcover,31,1999,1999,4.430000000000001,2450,0
0375867740,Hardcover,48,2011,2011,4.1,2449,0
1554532889,Hardcover,32,2009,2009,4.18,2446,0
0375870865,Hardcover,40,2012,2012,4.18,2445,0
0152045732,Paperback,64,1942,2003,4.26,2445,61
0156528401,Paperback,56,1942,1974,4.26,2445,32
1620102870,Paperback,208,2016,2016,3.92,2444,0
1596434333,Paperback,77,2011,2011,4.08,2442,0
0312930917,Hardcover,244,1988,1988,3.86,2440,0
9507828850,Paperback,256,2006,2006,3.3299999999999996,2436,0
0316111805,Hardcover,31,1984,1984,4.2,2435,0
0545646235,Paperback,96,2014,2014,4.2700000000000005,2434,0
0544104439,Hardcover,40,2014,2014,4.09,2429,0
0525474005,Hardcover,32,2005,2005,4.37,2427,0
0060560738,Paperback,224,1996,2004,3.93,2427,8
0399172580,Hardcover,32,2016,2016,4.24,2419,0
1419708082,Hardcover,128,2014,2014,4.38,2418,0
0486217841,Paperback,192,1888,1967,3.78,2417,79
1743624778,Hardcover,24,2014,2014,4.1,2416,0
0064431126,Paperback,48,1958,1986,4.23,2416,28
0375843884,Paperback,96,2009,2009,4.18,2416,0
0525428887,Hardcover,48,2017,2017,3.81,2414,0
1442417315,Board Book,16,2011,2011,4.26,2411,0
0307981460,Hardcover,40,2012,2013,4.11,2406,1
0375805621,Board Book,24,1996,2000,4.21,2397,4
0786839198,Hardcover,40,2007,2008,4.32,2396,1
2070548988,Paperback,24,1971,2002,4.22,2396,31
0374302278,Hardcover,32,1971,1971,4.22,2396,0
081187480X,Hardcover,108,2010,2010,4.06,2393,0
0375843914,Paperback,96,2012,2012,4.1,2393,0
0439829739,Hardcover,40,2006,2006,4.2700000000000005,2386,0
1932386947,Hardcover,144,2010,2010,3.96,2384,0
044981744X,Hardcover,40,2015,2015,4.37,2383,0
0689859848,Hardcover,40,2006,2006,4.15,2383,0
0307117235,Paperback,24,2000,2000,4.23,2383,0
081099724X,Hardcover,208,2011,2011,4.18,2383,0
1405203994,Paperback,234,1949,2003,4,2383,54
076367754X,Hardcover,40,2017,2017,4.2,2379,0
0062422502,Hardcover,40,2017,2017,4.6,2377,0
031612656X,Hardcover,40,2013,2013,3.98,2369,0
0374322171,Hardcover,32,2009,2010,4.1,2369,1
0399238735,Hardcover,32,2002,2002,4.17,2369,0
1440487219,Paperback,26,2006,2006,4.04,2364,0
0439598400,Paperback,40,2001,2004,4.06,2362,3
0140345434,Paperback,247,1940,1990,4.08,2361,50
0688147364,Hardcover,28,1990,1996,3.79,2360,6
1905417098,Hardcover,32,2006,2006,4.04,2358,0
1442413069,Hardcover,40,2012,2012,4.04,2357,0
0836249275,Hardcover,32,1844,1992,3.99,2357,148
0763639230,Hardcover,32,2008,2008,4.22,2351,0
0803724640,Hardcover,40,1844,2002,3.99,2351,158
0394845668,Hardcover,32,1980,1980,4.26,2348,0
0307021416,Hardcover,24,1949,2003,4.25,2338,54
1561453994,Hardcover,32,2007,2007,4.28,2333,0
0763646016,Hardcover,40,2013,2013,4.25,2330,0
1561453919,Hardcover,32,2007,2007,4.12,2329,0
0590431307,Paperback,144,1965,1986,4.09,2329,21
1477826351,Hardcover,32,2016,2016,3.83,2327,0
0140546162,Paperback,32,1981,1992,4.21,2326,11
0803733623,Hardcover,358,2010,2010,3.99,2322,0
0399215980,Hardcover,40,1971,1988,3.94,2314,17
1452103143,Hardcover,104,2013,2014,4.14,2313,1
0618654798,Hardcover,275,2006,2006,3.77,2313,0
0140502777,Paperback,72,1938,1989,4.03,2310,51
0007591357,Paperback,288,1967,2002,4.29,2310,35
1338233157,Hardcover,224,2019,2019,4.1,2309,0
0590326457,Paperback,118,1977,1982,4.119999999999999,2308,5
1626720819,Hardcover,40,2016,2016,4.28,2306,0
0765388405,Hardcover,208,2013,2016,4.39,2306,3
0689878338,Paperback,36,1970,2005,3.9,2304,35
0064432548,Paperback,32,1962,1991,4.08,2300,29
0671631985,Paperback,395,1983,1986,4.17,2299,3
1416914919,Hardcover,40,2005,2006,4.09,2296,1
0375867309,Paperback,96,2011,2011,4.24,2296,0
0375861815,Hardcover,26,2010,2010,4.01,2295,0
0394806697,Hardcover,36,1970,1970,4.25,2295,0
0618375945,Hardcover,34,2004,2004,4.34,2294,0
0375843876,Paperback,96,2008,2008,4.06,2293,0
0345320077,Paperback,128,1981,1992,4.23,2293,11
0230014917,Hardcover,25,2008,2009,3.93,2292,1
0698117875,Paperback,32,1986,1999,4.24,2292,13
0805097155,Hardcover,40,2015,2015,4.31,2291,0
006443205X,Paperback,48,1952,1989,4.23,2289,37
1596436689,Hardcover,40,2011,2011,4.22,2288,0
0395727677,Paperback,32,1992,1995,4.1,2282,3
0140309314,Paperback,286,1939,1997,4.09,2281,58
0545528445,Hardcover,192,2015,2015,4.18,2280,0
0440419263,Paperback,160,1976,2004,4.2,2279,28
0316125407,Paperback,195,1954,1988,4.04,2279,34
9515004691,Hardcover,28,1960,1998,4.44,2277,38
0395383684,Paperback,64,1966,1985,4.13,2277,19
0152164138,Hardcover,40,2003,2003,3.78,2276,0
1492633399,Hardcover,304,2015,2016,4.4,2268,1
0544357698,Hardcover,40,2016,2016,4.24,2266,0
0374300437,Hardcover,224,2016,2016,4,2263,0
0805079963,Hardcover,34,2007,2007,4.15,2261,0
009972541X,Paperback,32,1980,1996,4.18,2261,16
0375968326,Hardcover,44,2015,2015,4,2260,0
0694011770,Board Book,14,1998,1998,4.06,2260,0
0142300268,Paperback,256,1964,2001,4.159999999999999,2260,37
0345320107,Paperback,128,1982,1999,4.24,2259,17
1499801033,Hardcover,34,2016,2016,4.25,2257,0
0689818858,Hardcover,40,2001,2001,4.34,2254,0
0064432270,Paperback,24,1949,1999,4.109999999999999,2254,50
0064434877,Paperback,32,1995,1997,4.21,2253,2
0763623458,Hardcover,32,2012,2012,4.27,2251,0
0802853021,Hardcover,40,2008,2008,4.12,2248,0
080272843X,Hardcover,36,2012,2012,4.34,2245,0
0307122212,Hardcover,254,1939,1977,3.89,2244,38
0763665312,Hardcover,56,2015,2015,4.28,2240,0
0316404489,Hardcover,34,2018,2018,4.18,2236,0
0399257136,Hardcover,32,2011,2011,3.92,2234,0
1587171120,Paperback,240,1989,2001,3.81,2234,12
0679886524,Paperback,192,1984,1997,4.26,2230,13
0971216924,Paperback,176,2003,2006,4.05,2230,3
0805098259,Hardcover,40,2014,2014,4.19,2229,0
1909263745,Hardcover,64,2016,2016,4.37,2228,0
0888998732,Hardcover,24,2006,2008,4.37,2222,2
0152060510,Paperback,40,2007,2007,3.96,2219,0
0689846738,Paperback,55,1958,2001,3.98,2216,43
0698113853,Paperback,32,1988,1996,4.31,2215,8
1484722868,Hardcover,36,2016,2016,4.12,2213,0
0027653404,Hardcover,42,1984,1984,4.29,2212,0
0375849793,Hardcover,40,2010,2010,4.08,2211,0
0439922313,Hardcover,48,2008,2008,4.07,2211,0
0375956972,Hardcover,40,2010,2010,4.08,2211,0
068980623X,Paperback,32,1986,1996,4.109999999999999,2208,10
0330448390,Paperback,192,1950,2000,4.119999999999999,2207,50
0399250786,Hardcover,48,2010,2010,4.56,2205,0
148473162X,Hardcover,40,2017,2017,4.2,2203,0
0399235795,Hardcover,32,2000,2000,4.04,2202,0
0316431249,Hardcover,36,2018,2018,4.42,2198,0
0060255005,Hardcover,288,1962,1962,4.58,2192,0
1596436018,Paperback,216,2011,2011,3.8,2192,0
092023691X,Paperback,24,1986,1986,4.03,2190,0
0152021027,Paperback,32,1996,2000,4.37,2189,4
1481415247,Hardcover,48,2015,2015,4.18,2187,0
1452118949,Hardcover,40,2014,2014,3.96,2185,0
037583611X,Hardcover,40,2006,2006,4.13,2185,0
0553497049,Hardcover,112,2015,2015,4.33,2182,0
0590972197,Hardcover,32,1998,1998,4.17,2182,0
1416948643,Hardcover,40,2009,2009,3.99,2181,0
0316222585,Hardcover,40,2014,2014,4.12,2179,0
0595321836,Paperback,228,1965,2004,4.25,2175,39
0545166683,Hardcover,32,2014,2014,4,2174,0
8878744700,Hardcover,20,2016,2016,3.97,2173,0
0439098262,Hardcover,244,1967,2001,3.96,2170,34
0152325751,Hardcover,32,1987,1987,3.94,2167,0
141695046X,Hardcover,48,2009,2009,4.24,2160,0
0007182295,Hardcover,40,2008,2008,4.02,2160,0
1442420073,Hardcover,40,2011,2011,4.08,2159,0
1416958568,Hardcover,40,2012,2012,4.2,2158,0
0590434519,Paperback,182,1980,1981,3.76,2156,1
0152162755,Board Book,26,1995,2001,3.99,2154,6
0060560746,Paperback,198,1999,2004,3.95,2154,5
0395937485,Paperback,56,1987,1998,4.11,2153,11
0062008366,Paperback,88,2011,2011,4.2700000000000005,2151,0
0316070165,Hardcover,40,2010,2010,4.3,2149,0
0399247920,Hardcover,32,2007,2007,4.03,2149,0
0698116968,Paperback,32,1993,1998,4.2,2144,5
0749719796,Paperback,192,1954,1996,4.04,2144,42
0152053042,Hardcover,40,2005,2005,3.96,2142,0
1449476287,Paperback,174,2016,2016,4.23,2141,0
0763625973,Hardcover,32,2004,2005,4.47,2138,1
0312064195,Paperback,32,1984,1991,4.26,2134,7
0061363049,Hardcover,32,2009,2009,3.96,2132,0
0811866904,Hardcover,36,2013,2013,4.11,2130,0
0451469453,Hardcover,36,2016,2016,3.83,2126,0
0316045470,Hardcover,40,2012,2012,4.08,2126,0
006114018X,Hardcover,32,2007,2007,3.94,2126,0
0375803483,Paperback,256,1982,2000,3.5,2126,18
1401213871,Paperback,176,2008,2008,3.75,2125,0
0805089950,Hardcover,40,2011,2011,4.06,2119,0
0749719834,Paperback,180,1951,1996,3.98,2117,45
0811872378,Hardcover,40,2010,2010,4.02,2116,0
0439634253,Hardcover,40,2008,2008,4.2,2113,0
193151447X,Paperback,174,1999,2002,3.8,2112,3
0345449789,Paperback,96,1982,2003,4.23,2109,21
0761457119,Hardcover,32,2010,2010,4.18,2107,0
0394805771,Hardcover,40,1938,1966,4.04,2103,28
0547759363,Hardcover,40,2013,2013,3.97,2099,0
0375832327,Paperback,96,2006,2006,4.1,2098,0
184738210X,Paperback,32,2008,2008,3.91,2097,0
0803733658,Hardcover,208,2010,2010,4.23,2097,0
0544159039,Hardcover,32,2014,2014,4.05,2096,0
1401213812,Paperback,176,2007,2007,3.62,2095,0
1416908129,Hardcover,40,2008,2008,4.23,2094,0
015204731X,Paperback,304,1982,2003,3.95,2094,21
0399243259,Board Book,34,1988,2004,4.08,2092,16
1596437111,Hardcover,32,2012,2012,4.05,2089,0
0803739478,Hardcover,40,2013,2013,3.95,2086,0
0723247854,Hardcover,88,1908,2002,4.04,2085,94
0140562737,Paperback,40,1996,2001,4.13,2084,5
0007169965,Paperback,64,1953,2003,3.81,2083,50
054747105X,Hardcover,40,2013,2013,4.14,2077,0
1598168134,Paperback,192,2004,2007,4.06,2074,3
1416902767,Paperback,32,2002,2005,3.95,2072,3
0771066813,Paperback,256,1956,1987,3.97,2070,31
0763666483,Hardcover,48,2014,2014,3.96,2067,0
0439114942,Hardcover,48,2001,2001,4.07,2066,0
0064408590,Paperback,288,1949,2000,4.119999999999999,2063,51
1338540556,Paperback,208,2019,2019,4.33,2062,0
0060210982,Hardcover,32,1994,1994,4.4,2061,0
3522174410,Paperback,125,1956,2001,4.06,2057,45
0006932045,Paperback,128,1953,1988,4.02,2054,35
0670012939,Hardcover,34,2011,2011,3.79,2043,0
0440409675,Paperback,32,1974,1985,4,2040,11
1419714643,Hardcover,40,2015,2015,4.06,2038,0
0843174218,Paperback,32,1972,1998,4.05,2038,26
0374380236,Hardcover,48,2013,2013,4.18,2037,0
054514311X,Hardcover,32,2010,2010,4.119999999999999,2037,0
0545172241,Hardcover,24,2008,2008,4.28,2037,0
0374307989,Hardcover,32,2010,2010,4.109999999999999,2032,0
0375839887,Paperback,96,2007,2007,4.18,2032,0
0399225072,Hardcover,32,1993,1993,4.119999999999999,2027,0
0545110289,Hardcover,32,2009,2009,4.03,2024,0
1423178653,Hardcover,40,2014,2014,4.25,2023,0
0440863767,Paperback,230,2004,2005,3.63,2023,1
0152020985,Paperback,44,1996,2000,4.29,2012,4
1481426400,Hardcover,40,2016,2016,4.47,2010,0
0140542353,Paperback,48,1977,1990,4.109999999999999,2010,13
0440417546,Paperback,32,1950,2002,4.1,2008,52
0763656011,Hardcover,32,2012,2012,4.06,2004,0
0230704247,Hardcover,32,2010,2010,3.93,2001,0
0316770949,Hardcover,32,1812,1997,4.18,1998,185
0375837981,Paperback,96,2006,2006,4.1499999999999995,1992,0
0062671278,Hardcover,40,2018,2018,4.42,1990,0
1554532256,Hardcover,32,2008,2008,4.14,1988,0
006083157X,Hardcover,40,2008,2008,4.17,1988,0
0803741073,Hardcover,32,2014,2014,4.15,1986,0
0316155632,Hardcover,32,2003,2006,4.35,1985,3
0152057668,Hardcover,40,2006,2006,4.21,1983,0
0399163549,Hardcover,32,2014,2014,4.19,1982,0
0060743867,Hardcover,36,2007,2007,4.26,1982,0
1484726359,Hardcover,64,2016,2016,4.24,1977,0
0448431629,Paperback,144,2003,2004,3.88,1976,1
0380730227,Paperback,208,1989,1997,3.52,1976,8
1484726367,Hardcover,64,2016,2016,4.11,1973,0
0316519006,Hardcover,40,2019,2019,4.55,1964,0
0670014303,Hardcover,40,2013,2013,3.97,1964,0
0230704220,Hardcover,25,2009,2010,4.1,1964,1
0553537865,Hardcover,32,2018,2018,4.26,1963,0
1569711518,Paperback,112,1996,1996,4.05,1962,0
0140559086,Paperback,40,1994,2000,3.88,1960,6
0525452710,Hardcover,48,1994,1994,3.88,1960,0
0547152280,Hardcover,32,2010,2010,3.98,1960,0
0375857125,Paperback,96,2009,2009,4.17,1959,0
0061986755,Hardcover,40,2011,2011,4.11,1958,0
0843177233,Paperback,32,1978,2002,4.18,1958,24
0761352554,Hardcover,32,2010,2010,4.28,1953,0
0395266815,Paperback,64,1948,1978,3.97,1953,30
1419716476,Hardcover,40,2015,2015,4.08,1952,0
0062086960,Paperback,224,2012,2012,4.41,1949,0
0141317167,Paperback,328,1937,1937,4.05,1949,0
1328810151,Kindle Edition,112,2018,2018,4.1,1946,0
0613004108,Hardcover,25,1984,1996,4.35,1943,12
0439129109,Hardcover,208,2001,2001,3.63,1943,0
0689717512,Paperback,160,1937,1993,4.04,1943,56
0395311292,Paperback,48,1970,1981,4.2,1940,11
0399252185,Hardcover,216,2003,2009,3.95,1938,6
0060269456,Hardcover,40,1962,1962,3.93,1938,0
0763677302,Hardcover,40,2016,2016,4.37,1937,0
0688109942,Paperback,32,1984,1991,3.88,1937,7
0140562257,Paperback,43,1991,1997,4.1,1934,6
0061583081,Hardcover,208,2009,2009,4.24,1934,0
0547390084,Hardcover,32,2011,2011,3.9,1932,0
0803738684,Hardcover,40,2016,2016,4.07,1928,0
0763629200,Hardcover,32,2007,2007,4.2,1926,0
0689834578,Paperback,32,2002,2006,4.21,1922,4
0525555455,Hardcover,42,2018,2018,4.23,1921,0
1877579025,Hardcover,36,2006,2011,4.44,1919,5
0805063528,Hardcover,40,2002,2002,3.9,1917,0
0395866189,Paperback,32,1995,1997,4.22,1917,2
0312367473,Paperback,40,2002,2007,3.9,1917,5
0805090487,Hardcover,40,2013,2013,4.23,1914,0
1442430427,Hardcover,44,2012,2012,4.37,1914,0
1402287461,Hardcover,32,2013,2013,4.27,1912,0
0689817312,Paperback,32,1973,1997,3.76,1912,24
0761136193,Paperback,246,2004,2004,3.9,1909,0
0805068317,Paperback,40,1998,2002,4.21,1909,4
156145091X,Hardcover,32,1994,1994,4.01,1907,0
1542044286,Hardcover,40,2019,2019,3.86,1904,0
1596439858,Hardcover,26,2014,2014,3.97,1903,0
0698115910,Paperback,32,1961,1997,4.24,1901,36
0439639069,Hardcover,30,2007,2007,4.119999999999999,1899,0
0394836650,Hardcover,29,1979,1979,4.2700000000000005,1895,0
1419708031,Hardcover,96,2013,2013,3.95,1893,0
0811844285,Hardcover,36,2006,2006,4.31,1893,0
1452110239,Hardcover,40,2014,2014,3.76,1892,0
0723247811,Hardcover,64,1911,2002,3.89,1890,91
0618494960,Paperback,24,1940,2004,4.18,1887,64
0679826564,Hardcover,32,1991,1991,4.3,1886,0
0140367519,Paperback,292,1901,1996,3.95,1886,95
1442483199,Hardcover,40,2014,2014,4.43,1885,0
0230745369,Hardcover,32,2011,2011,4.01,1885,0
1596431954,Paperback,32,2004,2006,4.06,1885,2
0763661635,Hardcover,32,2013,2013,4.01,1881,0
0061728403,Hardcover,32,2010,2010,3.63,1881,0
1596439505,Hardcover,48,2017,2017,4.34,1877,0
0140566678,Paperback,32,1997,2000,4.04,1876,3
0761455299,Hardcover,32,2009,2009,4.26,1875,0
0545687918,Hardcover,32,2014,2015,4.23,1874,1
1554536499,Hardcover,32,2011,2012,4.17,1874,1
1626723214,Hardcover,32,2018,2018,4.46,1873,0
0545342783,Hardcover,40,2012,2012,4.04,1869,0
0603560741,Hardcover,510,2002,2002,4.319999999999999,1869,0
0723286698,Hardcover,32,2014,2014,4.05,1866,0
1484743628,Hardcover,38,2016,2016,4.07,1864,0
031605318X,Hardcover,48,2009,2009,4.38,1862,0
0688089186,Hardcover,32,1991,1991,4.31,1859,0
1587170248,Hardcover,212,1910,2000,3.96,1855,90
0811858227,Hardcover,108,2007,2007,4.109999999999999,1853,0
0763652849,Hardcover,32,2011,2011,4.21,1852,0
0064430103,Paperback,32,1956,1976,4.2,1850,20
1481456903,Hardcover,56,2016,2016,4.31,1849,0
0395316685,Paperback,80,1973,1981,4.26,1845,8
1402255446,Hardcover,32,2011,2011,4.05,1844,0
0140567437,Paperback,32,1968,2000,4.25,1844,32
0399230130,Board Book,20,1968,1996,3.93,1844,28
0802734103,Hardcover,40,2013,2013,4.19,1843,0
1879794845,Paperback,415,2011,2011,4.33,1840,0
0399166157,Hardcover,34,2014,2014,4.03,1837,0
1442402709,Hardcover,32,2011,2011,4.26,1835,0
1550371002,Paperback,32,1990,1990,4.06,1833,0
0618176764,Hardcover,32,2002,2002,4.14,1831,0
0152049681,Hardcover,143,2004,2004,3.88,1830,0
0007445466,Paperback,32,2012,2012,4.07,1829,0
0152060723,Hardcover,40,2008,2008,4.08,1829,0
0843178388,Paperback,32,1971,1998,4.03,1829,27
1862914958,Paperback,215,2003,2003,4,1828,0
1368046452,Hardcover,40,2019,2019,4.44,1827,0
1101918624,Hardcover,48,2016,2016,4.25,1826,0
1443155241,Hardcover,48,2016,2016,4.25,1826,0
0061236098,Paperback,32,2008,2008,4.02,1824,0
0316213608,Hardcover,42,2014,2014,4.06,1821,0
0395330750,Hardcover,32,1983,1983,4.07,1820,0
0802789471,Hardcover,32,2005,2005,4.08,1819,0
159362140X,Paperback,156,2008,2008,3.77,1817,0
0805003304,Paperback,32,1965,1972,3.74,1816,7
1553377362,Hardcover,32,2010,2010,3.92,1815,0
0152000763,Paperback,32,1988,1994,4.1,1814,6
0590445065,Paperback,32,1986,1987,4.01,1811,1
031602452X,Hardcover,43,2010,2010,3.86,1807,0
0375867139,Hardcover,32,2012,2012,4.2,1806,0
0307960242,Hardcover,24,1977,2001,4.14,1806,24
0064430448,Paperback,400,1963,1983,4.09,1804,20
1452128693,Paperback,112,2014,2014,3.73,1802,0
0920236316,Paperback,32,1982,1982,3.9,1798,0
0545370973,Hardcover,192,2013,2013,4.09,1797,0
0316882690,Hardcover,32,2007,2007,4.09,1796,0
0399538526,Hardcover,32,2017,2017,3.96,1794,0
0805090282,Hardcover,32,2009,2010,4.29,1794,1
1770495320,Hardcover,32,2015,2015,4.17,1791,0
0316365521,Hardcover,32,1997,2007,4.26,1790,10
0439649498,Board Book,12,2004,2004,4.05,1789,0
1626727465,Hardcover,42,2019,2019,4.46,1787,0
0062008374,Paperback,89,2011,2011,4.28,1787,0
1401214665,Hardcover,240,2007,2007,3.8,1787,0
0061664669,Hardcover,40,2010,2010,3.75,1780,0
038524469X,Paperback,48,1979,1988,4.31,1778,9
1596439661,Hardcover,32,2015,2015,3.74,1777,0
1596437162,Hardcover,40,2012,2012,4.2,1777,0
0887766862,Paperback,87,1975,2003,3.9,1775,28
1442472707,Hardcover,24,1971,2013,3.93,1774,42
0689826842,Paperback,32,1971,1999,3.93,1774,28
141691630X,Hardcover,36,2008,2008,3.99,1770,0
0763696072,Hardcover,40,2018,2018,4.09,1769,0
0399246363,Hardcover,32,2007,2007,3.89,1768,0
0590417010,Hardcover,40,1995,1995,4.46,1768,0
097239463X,Hardcover,32,2010,2010,4.27,1764,0
1580890148,Board Book,26,1993,1998,4.13,1762,5
0887761747,Paperback,24,1979,1985,4.2,1762,6
1929132735,Hardcover,32,2004,2006,4.119999999999999,1761,2
1596439327,Hardcover,40,2015,2015,3.9,1760,0
0763660973,Hardcover,32,2011,2012,4.1,1755,1
0988344890,Board Book,32,2012,2012,4.319999999999999,1755,0
1423168070,Hardcover,36,2014,2014,4.18,1754,0
0375839909,Paperback,96,2007,2007,4.14,1754,0
1499805527,Hardcover,40,2018,2018,4.4,1751,0
1598166379,Paperback,198,2005,2006,4.17,1751,1
0399250522,Hardcover,32,2011,2011,4.1499999999999995,1750,0
0809824205,Hardcover,137,1913,1972,4.14,1750,59
0547959222,Hardcover,40,2014,2014,4.23,1748,0
1580891136,Hardcover,32,2006,2006,4.1,1748,0
1742372929,Hardcover,48,2008,2010,4.470000000000001,1742,2
1773060201,Hardcover,40,2018,2018,3.84,1741,0
0316209171,Hardcover,40,2013,2013,4.43,1741,0
0064432793,Paperback,32,1989,1992,3.94,1740,3
1554534143,Hardcover,112,2010,2010,3.98,1739,0
0395426472,Paperback,32,1960,1986,3.65,1737,26
0062408739,Hardcover,40,2017,2017,3.93,1736,0
0590331256,Hardcover,32,1999,1999,4.25,1736,0
0374436363,Paperback,32,1976,1990,4.17,1735,14
0399257675,Hardcover,32,2012,2012,3.91,1730,0
0763620947,Board Book,32,1984,2004,4.1499999999999995,1729,20
0517885557,Paperback,32,1994,1997,3.82,1729,3
1626723311,Paperback,192,2015,2017,4.3,1729,2
0670277673,Hardcover,136,1947,1962,4.02,1729,15
0953522741,Hardcover,28,1952,2001,4.37,1727,49
0152024492,Paperback,32,1993,2001,4,1727,8
0152057153,Paperback,32,2002,2006,3.99,1726,4
006199846X,Hardcover,40,2011,2011,4.04,1725,0
1595327894,Paperback,192,2005,2005,3.74,1719,0
068985143X,Paperback,40,2002,2005,4.28,1717,3
1524772046,Hardcover,42,2018,2018,4,1715,0
9024569486,Hardcover,12,2011,2015,4.159999999999999,1715,4
030712844X,Paperback,24,1999,1999,4.319999999999999,1709,0
0698113640,Paperback,32,1992,1996,4.37,1708,4
0819304980,Hardcover,32,1971,1971,4.28,1708,0
006185283X,Hardcover,32,2011,2011,4.31,1705,0
0803734697,Hardcover,204,2010,2010,4.22,1705,0
1626725365,Hardcover,32,2017,2017,4.02,1704,0
1471115690,Ebook,32,2011,2013,4.16,1704,2
0312383711,Hardcover,32,2008,2008,4.26,1702,0
0811878694,Hardcover,32,2013,2013,3.95,1698,0
0545117151,Paperback,176,2010,2010,4.09,1697,0
1563054434,Board Book,24,1993,1993,4.1,1696,0
1421509296,Paperback,194,2006,2006,4.470000000000001,1695,0
055353789X,Hardcover,40,2017,2017,4.28,1693,0
144243385X,Hardcover,40,1967,2011,3.99,1688,44
1904442145,Paperback,32,2001,2004,3.99,1688,3
1596436042,Hardcover,40,2013,2013,3.9,1686,0
1596437170,Hardcover,32,2014,2014,4.1,1685,0
0544416864,Hardcover,34,2015,2015,4.11,1680,0
0698115635,Paperback,32,1993,1997,3.63,1676,4
1407132040,Hardcover,32,2012,2012,4.08,1675,0
0061996556,Hardcover,40,2011,2011,4.109999999999999,1675,0
1891830767,Paperback,143,2005,2006,4.23,1675,1
0590420577,Paperback,40,1990,1992,4.18,1674,2
0399243984,Hardcover,32,1987,2005,3.99,1671,18
0615197191,Paperback,128,2008,2008,4.470000000000001,1669,0
0140565086,Paperback,32,1971,1999,4.18,1667,28
0062379550,Hardcover,48,2015,2015,3.93,1665,0
0399242155,Hardcover,32,2004,2004,4.05,1665,0
0062008382,Paperback,88,2011,2012,4.33,1662,1
1481430955,Hardcover,40,2016,2016,4.36,1658,0
145212891X,Hardcover,40,2014,2014,4.16,1658,0
0670784893,Hardcover,40,2013,2013,3.88,1658,0
0345503139,Paperback,111,2008,2008,3.97,1657,0
0345335805,Paperback,128,1984,1999,4.2,1652,15
1844289109,Paperback,40,1990,2005,4.319999999999999,1650,15
0803739079,Hardcover,32,2015,2015,3.95,1649,0
1596434309,Hardcover,40,2009,2009,4.19,1649,0
0679886117,Hardcover,32,1997,1997,4.14,1649,0
1609050622,Hardcover,38,2011,2011,4.23,1647,0
0375867791,Paperback,96,2011,2011,4.25,1647,0
1454914041,Hardcover,40,2015,2015,4.24,1644,0
0761119760,Board Book,24,2000,2000,4.06,1642,0
1596438789,Paperback,160,2015,2015,4.17,1642,0
0375851194,Paperback,32,1999,2010,4.06,1641,11
1596439483,Hardcover,40,2014,2014,4.06,1639,0
1595302779,Kindle Edition,16,2013,2013,4.13,1639,0
0763608637,Paperback,32,1994,1999,4.1499999999999995,1639,5
1416978844,Hardcover,32,2010,2010,3.97,1635,0
1592701515,Hardcover,64,2013,2014,4.42,1632,1
0307001431,Hardcover,24,1953,2001,4.159999999999999,1630,48
9735057700,Hardcover,48,2017,2017,3.89,1629,0
0152053158,Board Book,30,2001,2004,4.31,1626,3
0810981548,Hardcover,44,1992,1998,4.14,1623,6
0545131502,Paperback,32,2006,2008,4.17,1622,2
0152009019,Paperback,44,1994,1994,4.319999999999999,1619,0
0152239456,Paperback,32,1993,1993,4.04,1619,0
1442458801,Hardcover,32,2014,2014,4.15,1618,0
0500651094,Hardcover,32,2017,2017,4.28,1617,0
141695855X,Hardcover,40,2011,2011,4.14,1617,0
1416979220,Hardcover,40,2010,2010,3.86,1616,0
0684188317,Hardcover,32,1949,1987,3.69,1615,38
0805079009,Hardcover,256,2006,2006,4.04,1608,0
1416978860,Hardcover,40,2012,2012,4.03,1607,0
078680890X,Hardcover,48,2012,2012,4.21,1607,0
0439551919,Paperback,48,1994,2006,4.13,1606,12
068980668X,Hardcover,40,1997,1998,4.04,1604,1
1891830899,Paperback,129,2007,2007,4.17,1604,0
0399239863,Hardcover,32,2013,2013,4.21,1602,0
0375865748,Paperback,96,2011,2011,4.109999999999999,1599,0
1416985131,Hardcover,32,2009,2009,3.98,1598,0
1368008445,Hardcover,240,2018,2018,3.96,1598,0
0425287688,Hardcover,52,2016,2016,4.3,1596,0
0819310077,Hardcover,44,1979,1979,4.46,1595,0
006028479X,Hardcover,69,1967,2001,4.1899999999999995,1591,34
0613283627,Hardcover,40,1997,2000,4.159999999999999,1589,3
1452138516,Hardcover,40,2015,2015,3.68,1586,0
1442435828,Hardcover,40,2013,2013,3.93,1586,0
031620384X,Hardcover,32,2012,2012,3.64,1584,0
0064400425,Paperback,256,1962,1973,4.05,1583,11
1596434279,Hardcover,32,2008,2008,4.03,1582,0
0786804297,Hardcover,32,1999,1999,4.22,1582,0
0689715684,Paperback,32,1950,1992,3.57,1581,42
1934287962,Paperback,147,2007,2010,4.4,1576,3
0545825016,Hardcover,176,2016,2016,3.9,1575,0
0142501530,Paperback,384,1985,2003,3.6,1575,18
0394927001,Hardcover,96,1974,1974,3.94,1574,0
0590326449,Paperback,181,1979,1979,4.17,1573,0
0316118257,Hardcover,40,2008,2008,4.15,1572,0
0449810801,Hardcover,32,2013,2013,4.35,1571,0
0395510066,Paperback,32,1985,1985,4.119999999999999,1570,0
1580892973,Hardcover,32,2016,2016,4.22,1569,0
0439598397,Paperback,32,1994,2004,4,1567,10
0394827074,Paperback,24,1974,1974,4.41,1564,0
0688109888,Paperback,40,1979,1991,4.119999999999999,1562,12
1481448897,Hardcover,40,2016,2016,4.1,1559,0
1554983479,Hardcover,32,2014,2014,4.15,1558,0
1592701876,Hardcover,30,2001,2016,4.39,1557,15
0064434990,Paperback,32,1990,1998,4.21,1554,8
0688070450,Paperback,32,1985,1987,3.9,1554,2
0723247870,Hardcover,58,1909,1987,3.79,1552,78
0689863756,Hardcover,40,2005,2005,3.85,1551,0
0060583045,Hardcover,264,2004,2004,3.63,1549,0
1442435798,Hardcover,160,2012,2012,4.02,1546,0
1613776055,Paperback,104,2013,2013,4.22,1543,0
076362442X,Hardcover,32,2004,2004,4.21,1543,0
0805081046,Hardcover,40,2007,2007,4.18,1540,0
0670249319,Hardcover,40,1955,1955,3.95,1540,0
0061456888,Hardcover,40,2008,2008,3.91,1539,0
0805046461,Paperback,32,1992,1992,3.93,1539,0
0316282839,Hardcover,40,2016,2016,4.01,1537,0
039530850X,Hardcover,32,1981,1981,4.28,1535,0
1423105656,Paperback,172,2009,2009,4.03,1535,0
1401302424,Hardcover,197,2005,2005,4.2,1534,0
0547818548,Hardcover,32,2013,2013,3.94,1532,0
0316188220,Hardcover,40,2015,2015,3.89,1531,0
1743625804,Hardcover,28,2015,2015,4.19,1530,0
0689847238,Hardcover,32,2003,2003,4.1,1526,0
0811855201,Hardcover,40,2007,2007,4.33,1526,0
1419721283,Hardcover,128,2017,2017,3.73,1524,0
0873585429,Hardcover,32,1992,1992,4.119999999999999,1524,0
037586573X,Paperback,96,2010,2010,4.14,1522,0
0099256053,Paperback,32,1981,1997,4.2700000000000005,1521,16
1524769568,Hardcover,32,2018,2018,4.39,1519,0
031611488X,Hardcover,56,2005,2005,4.49,1519,0
0062742469,Hardcover,40,2018,2018,4.37,1518,0
0590458469,Hardcover,40,1992,1992,4.24,1513,0
1452145423,Hardcover,48,2017,2017,4.07,1511,0
0062223976,Hardcover,30,2014,2014,3.79,1511,0
1558584862,Hardcover,24,1992,1999,4.14,1510,7
0061134015,Hardcover,32,2006,2006,4.16,1508,0
1481451626,Hardcover,42,2017,2017,4.37,1507,0
073642573X,Hardcover,72,2009,2009,4.359999999999999,1507,0
1626721270,Hardcover,40,2015,2015,4.25,1506,0
0140564403,Paperback,40,1969,1998,4.01,1506,29
0811831477,Hardcover,64,2001,2001,3.7,1501,0
0399554521,Hardcover,32,2018,2018,4.43,1499,0
0808528637,Hardcover,32,1976,1977,4.03,1497,1
0374385181,Hardcover,32,2009,2009,4.04,1495,0
0375837612,Hardcover,32,2004,2007,4.05,1492,3
0394733525,Paperback,62,1963,1977,4.33,1491,14
1626726035,Hardcover,40,2018,2018,3.77,1490,0
0763624306,Hardcover,40,2007,2007,4.15,1488,0
1556702884,Hardcover,32,1993,1996,4.41,1488,3
0688063632,Hardcover,32,1987,1988,4.25,1488,1
0345370295,Paperback,128,1991,1991,4.25,1488,0
0805055819,Paperback,32,1994,1997,3.91,1486,3
0763651079,Hardcover,32,2012,2012,3.91,1485,0
0590693301,Paperback,32,1996,1996,4.22,1477,0
0435124307,Paperback,90,1992,1995,3.54,1476,3
0802735606,Hardcover,40,2014,2014,4.18,1473,0
0723247838,Hardcover,82,1912,2002,3.9,1473,90
1442494921,Hardcover,40,2014,2014,3.96,1471,0
0345359569,Paperback,128,1989,1989,4.2700000000000005,1470,0
0803739087,Hardcover,32,2016,2016,3.81,1468,0
0763663514,Hardcover,48,2014,2015,4.22,1467,1
0439551927,Paperback,48,1999,2006,4.18,1466,7
0374302812,Hardcover,40,2017,2017,4.34,1465,0
1550370081,Paperback,32,1988,1992,3.97,1465,4
0531071669,Paperback,32,1996,2000,4.03,1464,4
0590413406,Paperback,36,1985,1988,4.31,1464,3
0803735251,Hardcover,204,2011,2011,4.28,1464,0
1626720568,Hardcover,40,2016,2016,3.79,1462,0
0395689821,Paperback,192,1989,1994,4.24,1462,5
0399167730,Hardcover,32,2014,2014,3.95,1460,0
0786837209,Hardcover,28,2005,2006,3.95,1460,1
0140019421,Paperback,235,1950,1999,4.3,1459,49
0451469542,Hardcover,34,2015,2015,3.92,1458,0
0763603341,Hardcover,40,1998,1998,3.98,1457,0
1423123123,Hardcover,40,2010,2010,3.83,1456,0
0060755547,Hardcover,56,2008,2008,3.87,1456,0
092023626X,Paperback,32,1982,1988,4.1,1456,6
0449813371,Hardcover,40,2016,2016,4.27,1455,0
043938849X,Paperback,32,1997,2002,3.95,1455,5
0545465133,Hardcover,128,2010,2013,4.29,1453,3
0763634042,Hardcover,40,2007,2007,4.04,1453,0
1421512041,Paperback,200,2007,2007,4.42,1451,0
1419716646,Hardcover,32,2015,2015,4.3,1449,0
0688155979,Board Book,32,1980,1997,3.71,1449,17
0152049509,Paperback,29,1993,2003,4.07,1447,10
144244276X,Kindle Edition,40,2012,2012,4.18,1445,0
0545478537,Hardcover,40,2015,2015,4.31,1444,0
0763663077,Hardcover,48,2013,2013,4.03,1444,0
076362814X,Hardcover,80,2005,2005,4.14,1443,0
0062331396,Hardcover,40,2016,2016,3.94,1442,0
0500277591,Hardcover,32,1978,1978,4.42,1439,0
0439424712,Paperback,138,1998,2003,3.86,1438,5
1596434538,Paperback,208,2010,2010,3.73,1437,0
0823420477,Hardcover,32,2017,2017,4.49,1435,0
0723247897,Hardcover,34,1906,2002,3.78,1434,96
0140508198,Paperback,32,1988,1990,4.119999999999999,1434,2
0374403856,Paperback,32,1930,1997,4.11,1433,67
0060211334,Hardcover,40,1993,1993,4.109999999999999,1433,0
0375845011,Hardcover,48,2009,2009,3.93,1432,0
1626721602,Paperback,272,2018,2018,4.35,1431,0
076366104X,Hardcover,32,2013,2013,3.9,1430,0
1467716081,Hardcover,32,2015,2015,4.32,1429,0
043985654X,Board Book,12,2006,2006,4.14,1429,0
0375814221,Hardcover,40,1981,2001,4.34,1428,20
153442167X,Hardcover,56,2019,2019,3.82,1426,0
1484712757,Hardcover,48,2016,2016,3.67,1425,0
0316343471,Hardcover,40,2017,2017,4.13,1422,0
1402243952,Hardcover,32,2008,2010,4.26,1420,2
1423133382,Hardcover,40,2011,2011,3.71,1418,0
1596438525,Hardcover,56,2016,2016,4.27,1417,0
0316376574,Hardcover,40,2015,2015,3.98,1417,0
1452138168,Hardcover,40,2016,2016,4.13,1416,0
0761339434,Hardcover,32,2015,2015,4.31,1415,0
0375857133,Paperback,96,2005,2010,4.109999999999999,1415,5
1452173184,Hardcover,50,2019,2019,4.26,1414,0
0763649244,Hardcover,40,2014,2014,4.07,1414,0
1626724261,Hardcover,160,2017,2017,3.86,1413,0
0374306672,Hardcover,40,2003,2003,4.2,1412,0
0545646251,Paperback,96,2014,2014,4.37,1412,0
080278819X,Hardcover,32,2010,2010,4.1,1411,0
0857633937,Hardcover,32,2015,2015,4.18,1410,0
1584859903,Paperback,132,2005,2005,3.95,1410,0
0374300496,Hardcover,32,2016,2016,3.92,1408,0
0698113586,Paperback,32,1987,1996,4.05,1408,9
0399257829,Hardcover,32,2012,2012,3.97,1406,0
142310451X,Hardcover,160,2008,2008,3.59,1406,0
0689862938,Hardcover,112,2004,2004,4.09,1406,0
0345368355,Paperback,128,1990,1990,4.28,1405,0
0761360042,Paperback,123,2010,2011,3.76,1404,1
0374520771,Paperback,331,1923,1988,3.73,1404,65
1441311580,Hardcover,40,2013,2013,4.23,1403,0
1558584226,Hardcover,32,1889,1995,4.26,1402,106
1423137353,Hardcover,144,2014,2014,3.86,1400,0
0805082670,Hardcover,28,2008,2008,4.03,1398,0
0395904951,Hardcover,32,1999,1999,4.1,1396,0
1442481773,Hardcover,32,2014,2014,4,1395,0
1600608981,Hardcover,40,2014,2014,4.14,1395,0
0590442856,Paperback,32,1986,1987,4.13,1394,1
0689830394,Hardcover,56,1958,1999,4.1899999999999995,1393,41
1481489151,Hardcover,48,2018,2018,4.7,1390,0
1935179012,Hardcover,32,2009,2009,3.86,1389,0
1591160812,Paperback,200,1997,2003,4.13,1389,6
0316183563,Hardcover,40,2013,2013,4.08,1388,0
1554537673,Paperback,64,2011,2011,4.08,1387,0
1552633381,Hardcover,64,1974,2001,4.109999999999999,1386,27
0806979437,Hardcover,24,2001,2001,4.24,1381,0
1452118906,Hardcover,52,2015,2015,4.35,1380,0
0761345981,Hardcover,46,1997,2010,3.95,1377,13
0525707182,Hardcover,32,2018,2019,4.33,1376,1
1590782860,Hardcover,32,2005,2005,3.94,1376,0
015253184X,Paperback,32,1986,1991,4.26,1375,5
1452112339,Hardcover,32,2015,2015,4.19,1374,0
0001713272,Paperback,62,1964,1964,4.18,1374,0
0547558651,Hardcover,40,2013,2013,4.08,1373,0
1452142947,Hardcover,56,2015,2015,3.95,1372,0
2723442756,Hardcover,48,2004,2004,4.07,1369,0
052555341X,Hardcover,40,2019,2019,4.35,1364,0
1939203716,Paperback,30,2016,2016,4.17,1363,0
0698113748,Paperback,32,1987,1996,4.12,1362,9
0440408296,Paperback,48,1961,1994,3.98,1360,33
0345331184,Paperback,128,1986,1986,4.26,1360,0
0590326430,Paperback,224,1982,1982,4.1899999999999995,1358,0
0679861874,Paperback,32,1991,1994,4.159999999999999,1357,3
0064432513,Paperback,48,1962,1991,4.2,1357,29
0395533074,Hardcover,32,1991,1991,3.98,1357,0
1452119368,Hardcover,52,2015,2015,4.15,1354,0
0763648485,Hardcover,48,2010,2010,4.15,1353,0
0803739397,Hardcover,80,2014,2014,4.25,1348,0
0340950625,Hardcover,30,2010,2010,4.11,1348,0
0545072700,Board Book,26,2009,2009,4.31,1348,0
0374374562,Hardcover,36,2014,2014,4.109999999999999,1347,0
0920236642,Paperback,32,1982,1982,3.98,1346,0
0670016934,Hardcover,40,2015,2015,4.17,1345,0
1423622022,Board Book,22,2011,2011,4.31,1345,0
1554987806,Hardcover,32,2016,2016,3.98,1344,0
0547979177,Hardcover,42,2015,2016,3.99,1343,1
0763677531,Hardcover,32,2019,2019,3.85,1342,0
1442466081,Hardcover,40,2014,2014,4.19,1342,0
0140567283,Paperback,32,1973,2000,3.93,1342,27
0152023720,Paperback,32,1994,2000,4.05,1339,6
1891830902,Paperback,88,2007,2007,3.84,1339,0
0736422382,Paperback,32,2004,2004,4.22,1338,0
0877888434,Hardcover,48,1984,2000,3.9,1338,16
1943200734,Hardcover,38,2018,2018,4.57,1337,0
0064431290,Paperback,40,1985,1987,4.01,1335,2
0375835962,Hardcover,32,2004,2006,3.77,1334,2
0786803959,Hardcover,32,1998,1998,4.05,1330,0
0750030062,Hardcover,32,1991,2000,4.33,1330,9
0316464465,Ebook,40,2019,2019,4.25,1329,0
1561459100,Hardcover,32,2016,2016,4.47,1329,0
0763661724,Hardcover,32,2012,2012,4.08,1329,0
0723248397,Hardcover,192,1981,2002,4.4,1329,21
0763646814,Hardcover,32,2010,2010,3.98,1327,0
0374468680,Paperback,32,1972,1987,4.09,1327,15
1408331594,Hardcover,32,2015,2015,4.359999999999999,1325,0
0671796135,Paperback,32,1991,1993,4.33,1324,2
089919799X,Paperback,40,1986,1988,3.98,1324,2
0979974674,Hardcover,32,2011,2011,4.19,1321,0
1596436204,Paperback,192,2011,2011,3.87,1321,0
0803736983,Hardcover,32,2011,2011,4.03,1320,0
1590383869,Hardcover,32,1998,2004,4.51,1320,6
0735227934,Hardcover,32,2019,2019,4.3,1319,0
0062748688,Hardcover,32,2019,2019,4.43,1315,0
059096075X,Hardcover,40,1999,1999,4.18,1314,0
039924302X,Hardcover,48,2004,2004,4.3,1313,0
0763669008,Hardcover,32,2015,2015,4.21,1310,0
0803739931,Hardcover,40,2014,2014,4.01,1310,0
0439135257,Hardcover,40,2001,2001,3.97,1309,0
0544087208,Hardcover,32,2015,2015,3.91,1308,0
0590203207,Hardcover,32,2002,2002,4.18,1308,0
0399250514,Hardcover,32,2009,2009,3.97,1306,0
1452150141,Hardcover,40,2018,2018,4.22,1304,0
0763696048,Hardcover,32,2018,2018,4.44,1299,0
1452106452,Hardcover,40,2012,2012,4.25,1299,0
0061452238,Hardcover,40,2008,2008,4.05,1298,0
1841210986,Paperback,32,2001,2002,4.09,1298,1
0399234772,Hardcover,32,2000,2000,4.05,1295,0
0723247846,Hardcover,82,1913,2002,3.67,1294,89
0545211425,Paperback,128,2010,2010,4.34,1294,0
0805089462,Hardcover,40,2011,2011,4.23,1293,0
0312097670,Paperback,32,1986,1993,4.35,1293,7
0375964479,Hardcover,96,2012,2012,3.97,1292,0
0688131638,Hardcover,48,1996,1996,4.34,1291,0
0698116321,Paperback,40,1992,1998,3.87,1290,6
0763639036,Hardcover,40,2008,2008,4.13,1288,0
1590170474,Hardcover,160,1973,2003,4.34,1287,30
0763653233,Paperback,32,2010,2013,4.01,1286,3
0399256113,Hardcover,32,2012,2012,3.8,1285,0
0763644374,Hardcover,32,2010,2010,4.01,1285,0
1442417420,Hardcover,40,2011,2011,3.88,1284,0
0618986766,Hardcover,32,2010,2010,3.99,1284,0
1596439157,Paperback,80,2014,2014,3.87,1284,0
043963430X,Hardcover,40,2010,2010,4.159999999999999,1283,0
0863154972,Hardcover,32,1910,2005,4.24,1283,95
0689711131,Paperback,46,1980,1987,4.4,1283,7
1452154430,Hardcover,48,2017,2017,3.84,1281,0
1909263087,Hardcover,32,2013,2013,4.24,1281,0
0439845009,Paperback,108,1976,2006,4.38,1281,30
1481400703,Hardcover,40,2017,2017,4.42,1279,0
0811878988,Hardcover,40,2011,2011,4.05,1278,0
1935279041,Hardcover,56,2007,2009,4.32,1274,2
0803729359,Hardcover,32,2006,2006,4.1899999999999995,1274,0
0547906501,Hardcover,32,2014,2014,4.25,1274,0
0811879054,Hardcover,32,2012,2012,4.35,1273,0
1608863220,Paperback,128,2012,2013,4.1499999999999995,1273,1
0803737009,Hardcover,40,2017,2017,4.4,1272,0
076365714X,Hardcover,40,2013,2013,4.01,1269,0
039923103X,Hardcover,48,1998,1998,4.18,1269,0
1402166516,Paperback,384,1851,2005,3.89,1269,154
1554534682,Hardcover,32,2011,2011,4.08,1268,0
0811872807,Hardcover,44,2010,2010,4.11,1267,0
1421575418,Paperback,196,1992,2015,3.99,1267,23
0759531455,Hardcover,192,2010,2010,3.99,1265,0
0763696803,Hardcover,40,2019,2019,3.8,1264,0
0618339248,Hardcover,80,2005,2005,4.119999999999999,1264,0
0062954520,Hardcover,40,2019,2019,4.21,1263,0
1419721305,Hardcover,40,2016,2016,4.16,1263,0
0152019510,Paperback,32,1994,1999,3.92,1262,5
0763675954,Hardcover,40,2014,2014,4.25,1261,0
0823418812,Hardcover,32,2006,2006,4.12,1260,0
1405204125,Paperback,160,1967,2003,3.69,1260,36
0007589220,Paperback,352,2016,2016,4.5,1259,0
0805062831,Hardcover,40,2003,2003,4.12,1258,0
0811871061,Hardcover,248,2012,2012,4.06,1258,0
0590441744,Paperback,208,1988,1991,4.02,1258,3
1481403605,Hardcover,40,2016,2016,4.11,1257,0
0316390968,Hardcover,34,2018,2018,4.43,1256,0
0545722888,Hardcover,48,2017,2017,4.22,1256,0
0763665428,Hardcover,32,2015,2015,3.98,1256,0
0763631965,Hardcover,32,2008,2008,4.07,1256,0
1596434694,Hardcover,56,2014,2014,4.05,1254,0
0802797547,Hardcover,32,2008,2008,4.38,1252,0
1596439750,Hardcover,32,2014,2014,3.94,1251,0
0761143726,Board Book,24,2006,2006,4.05,1250,0
1101935898,Hardcover,256,2018,2018,4.26,1250,0
0142301892,Paperback,32,1999,2002,3.96,1249,3
0395071763,Hardcover,48,1965,1990,4.67,1246,25
1626725616,Hardcover,128,2018,2018,4.13,1246,0
0803735650,Hardcover,40,2012,2012,4.02,1245,0
0670910589,Hardcover,40,2007,2007,3.7,1245,0
159643922X,Hardcover,32,2014,2014,3.93,1243,0
0956792685,Paperback,160,2012,2012,3.49,1243,0
1419723499,Hardcover,32,2017,2017,3.9,1242,0
076369035X,Hardcover,32,2017,2017,4.08,1241,0
1405089482,Hardcover,25,2007,2007,4.07,1241,0
0823413209,Paperback,32,1993,1996,4.28,1241,3
1885183585,Hardcover,168,1996,1996,4.41,1241,0
2205005855,Paperback,46,1971,1976,3.98,1240,5
1484704975,Hardcover,48,2018,2018,4.36,1239,0
1554988713,Hardcover,52,2017,2017,4.17,1238,0
1595827986,Hardcover,142,2011,2011,3.7,1238,0
193428713X,Paperback,149,2008,2011,4.38,1237,3
1581172206,Hardcover,14,2000,2003,4.109999999999999,1237,3
0152001212,Paperback,32,1991,1994,4.3,1237,3
1484717791,Hardcover,32,2017,2017,4.05,1234,0
1771381078,Hardcover,32,2010,2015,4.12,1234,5
1929132166,Hardcover,40,2000,2001,4.18,1233,1
1423103718,Hardcover,32,2015,2015,4.02,1232,0
0307340155,Hardcover,23,1957,2001,4.35,1232,44
0140553126,Paperback,32,1995,1997,3.99,1232,2
0152002235,Paperback,32,1991,1995,3.95,1232,4
0688085008,Hardcover,40,1994,1994,4.28,1232,0
0399256652,Hardcover,32,2012,2012,3.81,1230,0
006083160X,Hardcover,40,2009,2009,4.04,1230,0
1368003540,Hardcover,40,2017,2017,4.12,1229,0
0374300526,Hardcover,40,2014,2015,4.06,1229,1
039923201X,Hardcover,32,1999,1999,3.98,1229,0
0786839023,Hardcover,96,2007,2007,3.48,1229,0
1592701310,Hardcover,28,2009,2013,4.04,1228,4
0316392774,Ebook,40,2017,2017,3.48,1227,0
1565125681,Hardcover,304,2010,2010,3.85,1227,0
068985823X,Hardcover,40,2007,2007,4.04,1226,0
1423152204,Hardcover,44,2016,2016,4.05,1225,0
0735841632,Hardcover,32,2013,2014,4.22,1224,1
1626723141,Hardcover,40,2018,2018,4.02,1223,0
0763632414,Hardcover,32,2009,2009,3.84,1223,0
0571202128,Paperback,179,1958,2000,4.13,1223,42
0689855117,Hardcover,40,2005,2005,4.22,1222,0
1416909044,Hardcover,40,1996,2006,4.08,1221,10
0735841675,Hardcover,96,2014,2014,4.41,1220,0
0440405793,Paperback,80,1957,1992,3.9,1220,35
0761455604,Hardcover,32,2009,2009,4.18,1217,0
0811864790,Hardcover,40,2011,2011,4.29,1217,0
1596435992,Hardcover,40,2015,2016,4.32,1215,1
0544320417,Hardcover,24,2014,2014,4.31,1215,0
0689873417,Hardcover,32,2007,2007,3.87,1215,0
0689712030,Paperback,32,1971,1987,4.2700000000000005,1214,16
0061963313,Hardcover,40,2011,2011,3.99,1212,0
1557091390,Hardcover,32,1939,1990,4.24,1212,51
0374470278,Paperback,40,1996,2000,3.96,1211,4
1619639513,Hardcover,40,2016,2016,3.96,1209,0
0525516999,Kindle Edition,18,2018,2018,4.430000000000001,1208,0
1338028367,Hardcover,32,2016,2016,3.93,1207,0
006212594X,Hardcover,40,2013,2013,3.94,1207,0
1554535662,Hardcover,32,2010,2010,4.09,1207,0
0670699497,Hardcover,72,1940,1940,3.54,1206,0
0763696080,Hardcover,48,2019,2019,3.94,1205,0
1626721815,Hardcover,48,2016,2016,3.65,1205,0
0670061654,Hardcover,26,2007,2007,4.11,1205,0
1250303176,Hardcover,40,2019,2019,3.98,1204,0
0763661392,Hardcover,32,2014,2014,4.03,1204,0
1442413050,Hardcover,40,2011,2011,3.9,1203,0
0061372951,Hardcover,32,2008,2008,4.07,1203,0
0812509072,Paperback,288,1989,1990,3.89,1203,1
0439424747,Paperback,160,1999,2004,3.87,1203,5
0811866556,Hardcover,36,2009,2009,3.92,1202,0
1930900287,Hardcover,44,1964,2004,4.55,1202,40
014130815X,Paperback,64,1998,2000,4.06,1201,2
0805099115,Hardcover,40,2014,2014,3.85,1200,0
0803740824,Hardcover,40,2014,2014,4.39,1199,0
1626725071,Hardcover,40,2017,2017,3.49,1198,0
1481457837,Hardcover,40,2017,2017,3.83,1198,0
0763649090,Hardcover,56,2011,2011,4.23,1196,0
0061728462,Hardcover,32,2010,2010,3.72,1196,0
1423159063,Hardcover,50,2012,2012,3.88,1195,0
0374309221,Hardcover,40,2003,2003,4.470000000000001,1194,0
1570982066,Paperback,40,1961,1998,4.1499999999999995,1193,37
0590405160,Paperback,48,1983,1986,4.37,1193,3
0552549770,Paperback,24,2000,2007,4.23,1192,7
0440412102,Paperback,32,1998,2002,4.45,1192,4
0763658332,Hardcover,70,2017,2017,3.56,1191,0
0060092939,Hardcover,40,2006,2006,3.85,1191,0
0395349222,Paperback,112,1974,1983,4.24,1191,9
0062657607,Hardcover,40,2016,2017,3.9,1190,1
0062411063,Hardcover,32,2016,2016,4.29,1189,0
1592701566,Hardcover,60,2012,2014,4.17,1189,2
0545030153,Paperback,40,2007,2007,4.09,1189,0
0803741405,Hardcover,40,2016,2016,3.57,1188,0
006058081X,Hardcover,40,2006,2006,4.18,1188,0
031611491X,Hardcover,48,2006,2006,4.13,1186,0
1452154775,Hardcover,60,2016,2016,3.9,1178,0
0763624438,Board Book,24,2003,2004,3.97,1178,1
0689716605,Paperback,48,1964,1993,4.17,1178,29
0395321212,Paperback,80,1975,1982,4.159999999999999,1178,7
0316431273,Hardcover,40,2019,2019,4.52,1177,0
076367883X,Hardcover,34,2018,2018,4.1,1177,0
0192719467,Paperback,190,1942,2012,4.1,1177,70
0060271396,Hardcover,32,1999,1999,3.92,1176,0
0062059041,Paperback,192,1965,1996,4.159999999999999,1174,31
153441665X,Ebook,40,2019,2019,4.36,1173,0
0062223992,Hardcover,32,2015,2015,3.8,1173,0
0062081993,Hardcover,32,2012,2012,4.03,1172,0
1442465360,Hardcover,32,2014,2014,4.06,1171,0
0803740859,Hardcover,40,2014,2014,4.49,1171,0
0316129461,Hardcover,40,2012,2012,3.81,1169,0
061825627X,Hardcover,208,2002,2002,4.41,1169,0
0688099866,Paperback,32,1983,1990,4.22,1169,7
0812457749,Hardcover,107,1943,1986,3.87,1169,43
0375804714,Hardcover,192,1985,2000,4.24,1168,15
0803737513,Hardcover,32,2012,2012,4.45,1167,0
014055839X,Paperback,32,1987,1996,4.1,1167,9
0525645780,Board Book,34,2017,2018,4.24,1165,1
0545646286,Paperback,96,2015,2015,4.4,1164,0
1402766777,Hardcover,88,2004,2010,4.2,1161,6
0062252127,Hardcover,40,2016,2016,3.69,1158,0
0152046283,Hardcover,56,2008,2008,4.109999999999999,1158,0
159643967X,Hardcover,32,2017,2017,3.62,1157,0
0399243534,Hardcover,40,2017,2017,3.76,1156,0
1596438215,Hardcover,32,2014,2015,3.81,1156,1
0763626694,Hardcover,32,2005,2005,3.85,1156,0
0688151132,Paperback,32,1992,2004,4.22,1155,12
145212907X,Hardcover,40,2016,2016,3.77,1154,0
0375864555,Hardcover,32,2011,2011,3.96,1148,0
0803725019,Hardcover,32,2000,2000,4.359999999999999,1148,0
0618265112,Hardcover,32,2005,2005,4.17,1145,0
0152026088,Hardcover,40,2001,2001,4.1,1145,0
1587171619,Paperback,256,1989,2002,4,1144,13
1442451238,Hardcover,40,2013,2013,4.1,1143,0
1405090006,Hardcover,34,2007,2007,3.92,1143,0
1416980180,Hardcover,32,2010,2010,3.76,1142,0
1416955666,Hardcover,32,2009,2009,4.14,1142,0
1776570081,Kindle Edition,32,2015,2015,4.05,1141,0
0525428879,Hardcover,48,2015,2015,3.8,1141,0
1932319670,Hardcover,36,2008,2008,4.38,1139,0
039598033X,Board Book,28,1991,1999,3.91,1139,8
0374301859,Hardcover,40,2016,2016,4.07,1138,0
0544704525,Hardcover,40,2018,2018,4.52,1137,0
0375824294,Hardcover,40,2005,2005,3.97,1136,0
043954954X,Paperback,176,2002,2005,3.82,1136,3
1481480197,Hardcover,40,2016,2016,3.98,1134,0
1435120884,Hardcover,30,2001,2009,4.29,1133,8
006058940X,Paperback,40,2001,2004,3.88,1132,3
0803739141,Hardcover,40,2014,2014,4.06,1131,0
1935654144,Paperback,150,2009,2011,4.38,1131,2
0698114337,Paperback,48,1977,1997,4.13,1130,20
1905460139,Paperback,47,1968,2007,3.84,1129,39
1596438096,Hardcover,36,2013,2013,3.66,1128,0
0345347250,Paperback,126,1987,1987,4.159999999999999,1128,0
1770496459,Hardcover,96,2015,2015,4.04,1127,0
1449425674,Paperback,144,2012,2012,4.44,1124,0
0679883339,Paperback,32,1988,1997,4.08,1123,9
1250142733,Hardcover,32,2018,2018,4.38,1122,0
0140544429,Paperback,48,1959,1991,3.69,1122,32
0142402001,Paperback,32,2002,2004,3.94,1121,2
0140503943,Paperback,48,1978,1982,4.159999999999999,1119,4
044041850X,Paperback,128,1968,1968,4.21,1118,0
0763633437,Hardcover,16,2007,2007,4.22,1117,0
0399257187,Hardcover,40,2014,2014,3.99,1116,0
0803732171,Hardcover,32,2009,2009,4.06,1116,0
0761130667,Hardcover,24,2008,2008,4.18,1116,0
0689845006,Paperback,32,1978,2001,4.23,1116,23
0399163972,Hardcover,38,2015,2015,4,1115,0
0375868488,Hardcover,32,2012,2012,4.1899999999999995,1115,0
0061650994,Hardcover,40,2009,2009,4.1499999999999995,1114,0
1626722935,Hardcover,40,2017,2017,3.55,1112,0
1452119376,Hardcover,32,2016,2016,4.14,1112,0
039925238X,Hardcover,32,2010,2010,4.21,1112,0
0062651730,Hardcover,40,2018,2018,4.14,1111,0
0735842205,Hardcover,32,2016,2016,3.83,1108,0
0394871804,Hardcover,48,1985,1985,3.93,1108,0
1419700634,Hardcover,208,2011,2011,4.3,1108,0
0439153085,Hardcover,192,2003,2003,3.77,1108,0
0142300047,Paperback,40,1975,2001,4.17,1107,26
1554537711,Hardcover,32,2014,2014,3.92,1106,0
0671664670,Paperback,32,1973,1982,4.07,1106,9
0810970554,Hardcover,160,1986,2006,4.46,1106,20
0009780375,Hardcover,23,1975,2005,4.37,1104,30
1442435356,Hardcover,48,2012,2012,4.16,1103,0
0786836741,Paperback,128,2005,2005,4.17,1101,0
1477826394,Hardcover,32,2015,2015,3.95,1100,0
0316107581,Hardcover,32,1991,1991,4.42,1100,0
0688092411,Paperback,32,1986,1989,3.78,1100,3
0062393448,Hardcover,48,2019,2019,4.28,1099,0
0099265435,Paperback,32,1987,1998,4.17,1099,11
0807563730,Hardcover,32,2014,2014,4.22,1098,0
0399557261,Hardcover,40,2018,2018,4.35,1096,0
0395340667,Paperback,48,1971,1983,4.3,1094,12
0399251561,Hardcover,32,2017,2017,4.23,1093,0
2723448150,Hardcover,48,2005,2011,4.14,1091,6
1368036899,Hardcover,48,2019,2019,4.14,1090,0
0761367268,Hardcover,32,2012,2012,4.02,1090,0
1594203067,Hardcover,160,1177,2011,4.21,1089,834
144246738X,Hardcover,40,2014,2014,4.15,1088,0
1452114242,Hardcover,24,2011,2013,4.1,1088,2
0805069348,Hardcover,40,2009,2009,3.68,1088,0
0061152552,Hardcover,40,2007,2007,3.97,1087,0
080508682X,Hardcover,32,2008,2008,4.16,1086,0
0064401146,Paperback,192,1958,1959,3.88,1084,1
0345319281,Paperback,128,1985,1985,4.18,1084,0
0385390289,Hardcover,40,2015,2015,4.33,1083,0
0152019790,Hardcover,40,2006,2006,4.03,1083,0
1492667226,Hardcover,32,2019,2019,3.78,1081,0
1534400591,Hardcover,32,2018,2018,4.36,1081,0
0399207465,Hardcover,31,1980,1980,4.359999999999999,1080,0
0394800524,Hardcover,72,1968,1968,4.03,1080,0
0140363254,Paperback,135,1982,1992,3.86,1080,10
1626720398,Hardcover,40,2015,2015,4.29,1079,0
0375970967,Hardcover,96,2013,2013,4.21,1079,0
1561459178,Hardcover,32,2015,2015,3.83,1077,0
0547852851,Hardcover,40,2013,2013,4.13,1077,0
031209129X,Paperback,32,1985,1993,4.37,1077,8
0316502464,Hardcover,48,2017,2017,4.09,1076,0
1596438916,Hardcover,40,2014,2014,4.39,1076,0
1596436085,Hardcover,32,2012,2012,3.82,1075,0
0316930741,Board Book,24,1988,1998,4.07,1075,10
0375971955,Hardcover,40,2014,2014,3.91,1074,0
0763639125,Hardcover,32,2008,2008,4.08,1070,0
0979923840,Hardcover,40,2008,2008,3.79,1070,0
1452141991,Hardcover,32,2013,2015,4,1069,2
0545563186,Paperback,128,2014,2014,4.26,1067,0
0439395143,Hardcover,32,2002,2003,4.04,1066,1
0763600946,Hardcover,40,1997,1997,4.319999999999999,1065,0
0395272718,Paperback,48,1978,1978,4.1,1065,0
1554537681,Paperback,64,2012,2012,4.07,1065,0
0375966439,Hardcover,40,2013,2013,3.7,1064,0
0061152595,Hardcover,32,2009,2009,3.88,1064,0
0399556664,Hardcover,40,2019,2019,3.85,1063,0
0062364278,Hardcover,40,2015,2015,3.92,1063,0
0698113993,Paperback,32,1976,1996,3.93,1063,20
0061177601,Hardcover,40,2010,2010,3.98,1062,0
143381658X,Hardcover,40,2013,2014,4.22,1060,1
0689846177,Paperback,40,1994,2001,4.03,1060,7
014050558X,Paperback,32,1984,1986,4.26,1060,2
0027888355,Hardcover,32,1994,1994,4.03,1060,0
067001396X,Hardcover,40,2015,2015,4.18,1058,0
1943147302,Hardcover,40,2017,2017,4.38,1057,0
1592701671,Hardcover,32,2014,2014,4.25,1057,0
1416991506,Hardcover,40,2009,2009,4.03,1057,0
1926973356,Hardcover,32,2011,2012,4.3,1056,1
0394868773,Paperback,32,1984,1984,4.109999999999999,1056,0
0545865034,Hardcover,40,2019,2019,4.5,1055,0
0807530751,Hardcover,32,2016,2016,3.96,1055,0
0399256725,Hardcover,32,2013,2013,3.73,1055,0
0345341295,Paperback,128,1987,1987,4.159999999999999,1055,0
1401233570,Paperback,160,2012,2012,4.14,1054,0
1626720916,Hardcover,40,2016,2016,4.12,1053,0
8426134459,Hardcover,44,2004,2006,4.17,1053,2
1423157532,Hardcover,40,2012,2012,3.98,1052,0
0060842318,Paperback,160,1995,2006,3.79,1051,11
0345464591,Paperback,96,1983,2003,4.1499999999999995,1051,20
1587172445,Paperback,304,1990,2003,4.09,1051,13
0061684864,Hardcover,32,2009,2009,4.109999999999999,1050,0
0316525219,Hardcover,34,2019,2019,3.67,1049,0
1568462891,Hardcover,32,2016,2016,4.01,1049,0
1481424114,Hardcover,40,2015,2015,3.84,1049,0
1626721378,Hardcover,32,2017,2017,3.91,1048,0
0439915015,Hardcover,48,2013,2013,4.04,1048,0
0333493370,Paperback,40,1972,1972,4.159999999999999,1048,0
1592260004,Hardcover,24,1955,2010,3.83,1048,55
1442406208,Hardcover,40,2016,2016,3.93,1044,0
0590473786,Hardcover,40,2000,2000,4.1,1044,0
1534406581,Hardcover,40,2018,2018,4.06,1043,0
0064410951,Paperback,32,1997,2002,4.09,1043,5
1632896338,Ebook,32,2018,2018,4.3,1041,0
1419731653,Hardcover,32,2018,2018,4.319999999999999,1041,0
0316013579,Hardcover,40,2007,2007,3.96,1040,0
1554537703,Hardcover,32,2012,2012,3.91,1039,0
0544717139,Hardcover,160,2018,2018,4.33,1038,0
0618195637,Paperback,64,2000,2002,4.14,1038,2
0399242597,Hardcover,48,1981,2005,4.430000000000001,1037,24
1419705288,Hardcover,40,2013,2013,3.71,1036,0
1626722889,Hardcover,32,2017,2017,3.69,1035,0
0375831916,Hardcover,32,2005,2005,4.04,1035,0
1932386904,Hardcover,128,2010,2010,3.7,1035,0
186039678X,Hardcover,32,1996,1998,3.98,1032,2
3596800641,Paperback,180,2003,2003,4.2700000000000005,1031,0
1484782909,Hardcover,40,2018,2018,4.22,1030,0
0689844999,Paperback,64,1974,2001,4.46,1028,27
0763631973,Hardcover,45,2007,2007,3.9,1028,0
0064402274,Paperback,224,1982,1988,3.92,1028,6
1419726439,Hardcover,32,2018,2018,4.2,1027,0
1484723023,Hardcover,40,2017,2017,4.1499999999999995,1027,0
1416927271,Paperback,32,2003,2007,4.03,1027,4
0140556664,Paperback,24,1994,1997,4.11,1027,3
0140503064,Paperback,32,1977,1980,4.159999999999999,1027,3
1406308668,Hardcover,32,2008,2010,4.01,1026,2
0375847626,Hardcover,40,2011,2011,3.93,1025,0
0803726511,Hardcover,32,2003,2003,4.28,1025,0
0140565701,Paperback,32,1998,1999,3.96,1025,1
0307103366,Hardcover,24,1952,2003,4.119999999999999,1022,51
0979923891,Hardcover,32,2009,2009,3.74,1022,0
0064433978,Paperback,48,1993,1996,3.82,1022,3
0006724167,Paperback,192,1927,2003,3.81,1021,76
0439439744,Hardcover,32,2003,2003,3.89,1020,0
0735842620,Hardcover,128,2016,2016,4.54,1020,0
0451474961,Paperback,40,2016,2016,3.91,1019,0
0062274473,Hardcover,40,2015,2015,3.97,1019,0
0061253650,Hardcover,32,2008,2009,4.22,1018,1
0152055738,Hardcover,40,2006,2006,4.09,1018,0
1452103623,Hardcover,34,2012,2012,4.01,1015,0
0062198564,Hardcover,32,2015,2015,3.71,1014,0
0061914622,Hardcover,40,2011,2011,3.74,1014,0
030796034X,Board Book,24,1993,2002,4.319999999999999,1014,9
1442445513,Hardcover,40,2012,2012,4.07,1013,0
1929132670,Hardcover,32,1999,2004,4.159999999999999,1013,5
0843138211,Paperback,32,1976,1995,4.2,1013,19
0152009868,Paperback,36,1990,1996,4.01,1012,6
1590171004,Hardcover,376,1944,2004,3.96,1012,60
1442453362,Hardcover,40,2014,2014,3.92,1011,0
1405052155,Hardcover,32,2006,2006,4.1,1011,0
1481442848,Hardcover,40,2017,2017,3.87,1008,0
1338289411,Hardcover,32,2019,2019,4.26,1007,0
0763647284,Hardcover,40,2010,2010,4.15,1007,0
0590444255,Paperback,32,1985,1987,4.3,1007,2
0152053379,Hardcover,40,2009,2009,3.98,1006,0
0061214418,Hardcover,32,2008,2008,3.88,1005,0
0689852193,Hardcover,40,2005,2005,4.34,1003,0
0547752679,Hardcover,32,2013,2013,3.79,1002,0
0765109514,Hardcover,32,1942,1999,4.07,1001,57
0545914388,Hardcover,32,2016,2016,4.12,1000,0
1616551925,Hardcover,80,2013,2013,4.119999999999999,1000,0
0062248170,Hardcover,48,2014,2014,4.02,999,0
0099182211,Paperback,272,1949,1993,3.91,999,44
1101932422,Hardcover,32,2015,2016,4.14,998,1
0316203378,Hardcover,40,2016,2016,4.3,998,0
0761455256,Hardcover,32,2009,2009,4.22,997,0
0385373309,Hardcover,40,2015,2015,4.15,995,0
0805090495,Hardcover,32,2015,2015,4.28,995,0
1481469118,Hardcover,40,2018,2018,4.04,994,0
0062360167,Hardcover,40,2017,2017,3.98,994,0
0345320115,Paperback,128,1983,2003,4.1,994,20
1481460927,Hardcover,40,2017,2017,3.77,993,0
0545143152,Hardcover,40,2013,2013,3.94,993,0
1508802432,Kindle Edition,22,2012,2012,4.2700000000000005,992,0
0385079117,Hardcover,59,1961,1961,4.319999999999999,990,0
0062370952,Hardcover,32,2015,2015,3.85,989,0
1627794158,Hardcover,32,2016,2016,3.88,987,0
0590341308,Paperback,32,1997,1997,4.1,987,0
0688099300,Paperback,24,1986,1986,3.91,987,0
0385389906,Hardcover,40,2016,2016,3.89,986,0
0802733964,Hardcover,40,2013,2013,4.04,985,0
0439738199,Paperback,32,2005,2005,4.2700000000000005,985,0
0688117198,Hardcover,24,1993,1993,4.37,985,0
2924336015,Kindle Edition,24,2013,2016,3.73,984,3
1935654217,Paperback,142,2010,2011,4.4,984,1
0439435404,Hardcover,32,2004,2004,4.13,984,0
0688159788,Board Book,24,1993,1998,4.37,984,5
1684150329,Paperback,112,2017,2017,3.64,983,0
0140566570,Paperback,32,2000,2002,4.01,982,2
0385753357,Hardcover,40,2015,2015,4.24,981,0
0763678104,Hardcover,32,2014,2015,4.09,980,1
1338112473,Hardcover,42,2018,2018,3.93,979,0
1561452084,Hardcover,32,2000,2000,4.3,979,0
0545646324,Hardcover,96,2015,2015,4.44,979,0
1481405144,Hardcover,40,2015,2015,3.97,978,0
0062304186,Hardcover,24,2015,2015,3.68,977,0
1423133390,Hardcover,40,2010,2010,3.81,977,0
1596436506,Hardcover,64,2010,2010,3.66,977,0
0689843976,Hardcover,208,2003,2003,3.85,977,0
031634348X,Hardcover,32,2017,2017,3.9,975,0
014030844X,Paperback,128,1968,1976,3.73,973,8
0618756396,Hardcover,32,2007,2007,3.98,972,0
1416903089,Paperback,32,1986,2005,3.78,972,19
039923196X,Hardcover,40,2003,2003,4.03,972,0
0670013145,Hardcover,40,2012,2012,4.04,969,0
0547429223,Hardcover,32,2011,2011,4.02,968,0
0688131077,Paperback,40,1994,1994,4.159999999999999,968,0
0670013269,Board Book,12,2012,2012,4,967,0
0547928521,Hardcover,32,2014,2014,3.9,965,0
1416925171,Hardcover,32,2006,2006,4.03,965,0
0385389868,Hardcover,40,2015,2015,3.53,964,0
0316770620,Paperback,32,1990,1993,4.31,964,3
1626724423,Hardcover,40,2019,2019,3.5,963,0
0545865042,Hardcover,40,2016,2016,3.9,963,0
0064438538,Paperback,32,1999,2001,3.96,963,2
0689817746,Board Book,18,1977,1997,4.15,962,20
0375840680,Hardcover,40,2007,2007,4.109999999999999,961,0
0140503447,Paperback,32,1963,1981,4.18,960,18
0062475762,Hardcover,40,2019,2019,4.51,959,0
0670785016,Hardcover,32,2013,2013,4.14,959,0
1561455792,Hardcover,32,2011,2011,3.77,959,0
0152167323,Hardcover,32,2006,2006,3.87,959,0
0823423476,Hardcover,32,2011,2011,4.06,956,0
0374380686,Hardcover,32,2012,2012,4.08,955,0
0763631094,Hardcover,32,2009,2009,4.14,955,0
0152065458,Hardcover,32,2008,2008,4.34,955,0
1603090193,Paperback,173,2008,2008,4.1899999999999995,955,0
006235485X,Hardcover,32,2016,2016,3.74,954,0
0345351584,Paperback,128,1988,1988,4.14,954,0
0836210255,Paperback,128,1996,1996,4.29,953,0
1606840134,Hardcover,208,2010,2011,3.89,952,1
0803734791,Hardcover,40,2011,2012,3.95,951,1
0803728808,Hardcover,32,1967,2003,4.13,951,36
014056442X,Paperback,32,1968,1998,4.03,951,30
1442458240,Hardcover,40,2012,2012,3.88,950,0
0399242678,Hardcover,40,2005,2005,4.11,950,0
0152010769,Hardcover,32,2000,2000,4.03,950,0
0345353889,Paperback,124,1988,1988,4.18,950,0
1481435183,Hardcover,48,2016,2016,4.03,949,0
1423134869,Hardcover,40,2011,2011,3.72,948,0
1743629095,Hardcover,24,2015,2015,3.94,947,0
1452112657,Hardcover,40,2013,2013,3.93,947,0
1905417586,Hardcover,32,2007,2007,3.96,946,0
0899197213,Hardcover,32,1989,1989,4.34,946,0
0448400901,Hardcover,256,1987,1987,4.25,946,0
0060518987,Paperback,32,1946,2003,4.17,945,57
1770498095,Hardcover,32,2016,2016,4.29,943,0
0062668285,Hardcover,40,2018,2018,3.75,941,0
1442403772,Hardcover,40,2011,2011,3.76,941,0
0763650706,Hardcover,32,2013,2013,3.9,940,0
0525554165,Hardcover,32,2019,2019,4.48,939,0
1596435631,Hardcover,40,2011,2011,4.05,939,0
0744552397,Paperback,26,1989,1997,3.96,938,8
1932664467,Paperback,176,2006,2006,3.91,938,0
0345386663,Paperback,128,1994,1994,4.25,938,0
0030152569,Paperback,224,1975,1975,4.31,938,0
1596433388,Hardcover,48,2010,2010,3.9,937,0
0786849584,Hardcover,48,2009,2009,3.92,937,0
0763666211,Hardcover,32,2013,2013,3.87,936,0
1849417792,Paperback,32,2012,2012,4.46,936,0
0545218292,Hardcover,32,2010,2010,3.81,936,0
0803735278,Hardcover,208,2011,2011,4.25,936,0
1423185161,Hardcover,48,2016,2016,3.52,935,0
0439635691,Hardcover,40,2004,2004,3.81,935,0
0230704239,Hardcover,32,2009,2010,4.24,934,1
1419718819,Hardcover,40,2016,2016,4.17,933,0
1627796428,Hardcover,40,2017,2017,4.1,931,0
0395442354,Paperback,32,1984,1987,4.109999999999999,931,3
1368002145,Hardcover,48,2017,2017,3.62,930,0
1554987946,Hardcover,32,2016,2016,4.49,929,0
0544045491,Hardcover,36,2014,2014,3.87,928,0
0763663522,Hardcover,32,2012,2013,3.98,928,1
0375962263,Hardcover,40,2012,2012,4.17,928,0
0374380511,Hardcover,32,2008,2008,4.21,928,0
1402238355,Hardcover,32,2010,2010,3.98,927,0
1596439211,Hardcover,32,2015,2015,4.02,926,0
006117114X,Hardcover,40,2007,2007,3.95,925,0
0823442616,Hardcover,40,2019,2019,4.26,923,0
1743625782,Hardcover,24,2015,2015,4.15,922,0
1416903119,Paperback,40,1970,2005,3.9,922,35
0763681202,Hardcover,32,2016,2016,4.1,920,0
144246741X,Hardcover,40,2015,2015,3.82,920,0
1250107237,Hardcover,40,2018,2018,4,919,0
0807512982,Hardcover,32,2015,2016,4.09,919,1
155453092X,Hardcover,32,1986,2006,4.37,918,20
051788576X,Paperback,32,1996,1998,4.03,918,2
0525428259,Hardcover,40,2016,2016,3.93,917,0
1101919019,Hardcover,40,2017,2017,4.32,915,0
1452111901,Hardcover,36,2015,2015,4,915,0
0763658308,Hardcover,32,2012,2012,3.96,915,0
1402708610,Board Book,22,2002,2003,4.19,915,1
1442476613,Ebook,40,2014,2014,4.04,912,0
0340726911,Paperback,191,1992,2001,3.91,912,9
0007262388,Hardcover,30,2007,2007,4.02,911,0
0899197965,Paperback,32,1986,1988,3.87,911,2
1416990321,Hardcover,32,2012,2012,3.63,910,0
0345464672,Paperback,96,1984,2004,4.14,910,20
0764154516,Hardcover,32,2002,2002,3.98,909,0
1935179187,Hardcover,80,2012,2012,3.71,908,0
080756804X,Hardcover,32,2010,2011,4.25,907,1
1909263435,Hardcover,40,2015,2015,3.93,905,0
1935654357,Paperback,149,2011,2012,4.4,905,1
1587170000,Hardcover,96,2000,2000,4.26,904,0
0786809264,Hardcover,36,2002,2003,4.23,902,1
0140502424,Paperback,32,1973,1978,4.23,902,5
0375974261,Hardcover,32,2015,2015,4.22,901,0
0553507710,Hardcover,40,2016,2016,3.56,899,0
0763677337,Hardcover,40,2017,2017,4.37,897,0
2723452522,Hardcover,48,2006,2012,4.159999999999999,897,6
0345375793,Paperback,128,1992,1992,4.22,897,0
0316059625,Hardcover,32,2004,2005,4.31,896,1
0340893648,Hardcover,512,1949,2004,4.04,896,55
0152057447,Paperback,32,2003,2006,4.06,895,3
0395837332,Paperback,32,1944,1997,4.109999999999999,895,53
1338187376,Hardcover,32,2017,2018,3.91,894,1
1553796780,Paperback,47,2017,2017,3.7,894,0
148472173X,Hardcover,32,2016,2016,3.91,893,0
0399252843,Hardcover,32,2014,2014,4.14,893,0
0439880505,Hardcover,12,2006,2006,4.07,893,0
0531071073,Paperback,32,1995,1998,3.99,893,3
1479596183,Hardcover,32,2016,2016,3.91,893,0
1452139970,Hardcover,32,2017,2017,4.34,892,0
082340787X,Hardcover,32,1990,1990,4.09,892,0
0448043335,Paperback,48,1979,1990,4.31,892,11
0142401250,Paperback,32,1995,2004,3.85,890,9
184941808X,Paperback,32,2013,2013,4.29,890,0
0230741088,Hardcover,32,2012,2012,4.31,888,0
0064438562,Paperback,40,2000,2002,4.4,888,2
054773395X,Hardcover,32,2013,2013,3.92,887,0
1414319479,Hardcover,288,2006,2008,3.65,887,2
0152025227,Hardcover,40,2007,2007,4.12,886,0
0374399697,Hardcover,48,2000,2000,3.99,886,0
0803736770,Hardcover,208,2012,2012,4.33,885,0
0590439413,Paperback,217,1991,1994,3.98,885,3
0618051589,Board Book,28,1976,2000,4.07,884,24
148142064X,Hardcover,40,2015,2015,4.12,882,0
0688158455,Paperback,32,1994,1998,4.1499999999999995,881,4
0439926238,Paperback,224,2007,2008,3.89,881,1
0061692840,Hardcover,40,2011,2011,4,880,0
0916291545,Paperback,48,1987,1994,4.29,880,7
0399550569,Hardcover,40,2018,2018,4.04,879,0
1452106444,Hardcover,40,2013,2013,3.93,879,0
1596431504,Hardcover,32,2011,2011,3.73,879,0
1503937453,Hardcover,32,2017,2017,3.95,876,0
1400065585,Kindle Edition,40,2005,2010,4.159999999999999,876,5
0061724556,Hardcover,32,2009,2009,3.85,875,0
0689869312,Paperback,185,1997,2004,3.7,875,7
0345379594,Paperback,128,1992,1992,4.2,875,0
1909263494,Hardcover,32,2014,2014,4.01,874,0
0064471276,Paperback,208,1992,1999,3.63,871,7
0964380366,Paperback,48,1946,1998,4.1,870,52
0694006254,Board Book,32,1989,1994,3.73,870,5
0595321828,Paperback,200,1966,2004,4.17,870,38
0345407709,Paperback,128,1996,1996,4.2,869,0
1626720665,Hardcover,40,2018,2018,4.19,868,0
0735842698,Hardcover,40,2017,2017,4.119999999999999,867,0
0316370274,Hardcover,32,2014,2014,3.99,867,0
155453464X,Hardcover,32,2006,2009,4.1,867,3
0816644160,Hardcover,40,1933,2004,3.82,867,71
0394805712,Paperback,144,1987,1988,3.73,867,1
1742832709,Hardcover,32,2012,2012,3.97,865,0
0060777540,Hardcover,32,2005,2005,4,865,0
0345475615,Paperback,96,1985,2005,4.1899999999999995,865,20
0394826922,Hardcover,36,1973,1973,4.1,864,0
0374300038,Hardcover,32,2015,2015,3.9,863,0
0689846681,Paperback,32,1998,2002,4.18,863,4
068981013X,Paperback,48,1990,1996,4.1,863,6
0590477099,Hardcover,32,1994,1998,3.94,862,4
0374423296,Paperback,656,1997,1997,4.39,862,0
0330397281,Paperback,137,1997,2001,3.81,861,4
0735230374,Hardcover,34,2018,2018,4.29,860,0
0374306966,Hardcover,32,2013,2013,3.95,860,0
0230745377,Hardcover,26,2012,2012,3.77,860,0
1619631784,Hardcover,32,2014,2014,3.93,859,0
0590484206,Paperback,32,1994,1994,4.1499999999999995,859,0
006257311X,Hardcover,40,2017,2017,4.01,857,0
1338053140,Hardcover,40,2017,2017,3.55,857,0
0439448611,Hardcover,32,2013,2013,4.1,857,0
0439707846,Paperback,257,2003,2004,3.7,857,1
0440418186,Paperback,224,1980,2002,3.74,857,22
1481429337,Paperback,36,2016,2017,3.69,856,1
0395629748,Paperback,32,1990,1992,3.79,856,2
1771387270,Hardcover,32,2017,2017,3.95,855,0
0544308328,Hardcover,32,2015,2015,3.69,855,0
043992961X,Hardcover,40,2008,2008,3.93,855,0
0545776430,Hardcover,32,2017,2017,3.77,852,0
0152019677,Paperback,32,1988,1999,3.96,852,11
0060224975,Hardcover,64,1992,1992,4.06,852,0
0803739842,Hardcover,225,2016,2016,4.2700000000000005,852,0
1591822947,Paperback,203,1997,2003,3.51,852,6
0451155580,Paperback,116,1917,1971,3.95,852,54
1620147920,Hardcover,32,2019,2019,4.35,851,0
155379673X,Hardcover,25,2016,2016,4.39,851,0
1423116712,Hardcover,40,2011,2011,3.7,851,0
0810954737,Hardcover,44,2006,2006,4.22,851,0
014240408X,Paperback,176,1976,2005,4.01,851,29
0618339280,Hardcover,32,2003,2003,4.09,851,0
1416935053,Hardcover,40,2010,2010,4.21,850,0
0763642541,Hardcover,24,1992,2009,3.75,850,17
0142403628,Paperback,48,2002,2005,4.35,850,3
1481461311,Hardcover,48,2017,2017,4.35,848,0
0439206383,Hardcover,32,1999,2001,4.31,848,2
1413901441,Paperback,188,2000,2004,3.84,847,4
0451474988,Hardcover,40,2019,2019,4.22,846,0
0545883784,Hardcover,32,2016,2016,3.8,846,0
0062252062,Hardcover,40,2014,2014,3.95,846,0
0439799597,Hardcover,32,2005,2006,3.94,846,1
0152020969,Paperback,32,1995,1999,4,846,4
0374375526,Hardcover,64,1998,1998,4.13,846,0
0451121503,Paperback,151,1982,1983,4.359999999999999,845,1
1454920009,Hardcover,48,2017,2017,4.39,844,0
0316238015,Hardcover,32,2014,2014,3.92,844,0
1416907246,Hardcover,34,2008,2008,3.8,844,0
054591387X,Paperback,96,2016,2016,4.44,844,0
1481480391,Hardcover,64,2019,2019,4.42,843,0
1416996494,Hardcover,32,2011,2011,3.77,843,0
0545094194,Hardcover,32,2010,2010,4.02,842,0
0761454381,Hardcover,24,2008,2008,4.06,842,0
0064433390,Paperback,32,1988,1993,4.03,842,5
1596439319,Hardcover,40,2015,2015,3.78,841,0
0803741006,Hardcover,88,2014,2014,4.28,841,0
0449816818,Hardcover,48,2013,2013,4.1899999999999995,841,0
0375836071,Hardcover,40,2009,2009,4.04,840,0
1604693630,Hardcover,340,2013,2013,4.25,839,0
0899191630,Paperback,40,1975,1983,3.83,839,8
0061127590,Hardcover,32,2008,2008,4.07,835,0
0689817223,Paperback,32,1988,1997,4.08,834,9
0545436826,Hardcover,40,2015,2015,3.94,833,0
1620148374,Hardcover,32,2019,2019,4.55,832,0
0618755020,Hardcover,32,2006,2006,3.82,831,0
0544876830,Hardcover,40,2018,2018,3.95,830,0
0399254773,Hardcover,40,2011,2011,4.04,830,0
0152049703,Hardcover,32,2005,2005,4.1499999999999995,830,0
0744597978,Hardcover,32,2004,2004,3.88,830,0
0385755074,Hardcover,40,2015,2015,4.14,826,0
1452102031,Hardcover,40,2014,2014,4.02,826,0
0803738528,Hardcover,32,2013,2013,3.85,826,0
0760703558,Hardcover,18,1966,1996,4.2700000000000005,826,30
0316011800,Hardcover,32,2006,2006,4.08,825,0
0590100483,Hardcover,32,1997,1997,3.94,825,0
0517572656,Paperback,32,1985,1988,4.3,825,3
0590109723,Paperback,32,1996,1997,3.86,824,1
1442430575,Hardcover,48,2015,2015,4.29,823,0
1593692595,Paperback,126,2006,2007,4.02,823,1
0152002464,Paperback,44,1995,1995,4.42,822,0
0894808249,Paperback,96,1990,1990,3.94,821,0
0316562580,Hardcover,34,2018,2018,4.37,820,0
1250191734,Paperback,272,2019,2019,4.28,820,0
1481435698,Hardcover,32,2016,2016,4.1,819,0
1407120662,Hardcover,32,2012,2012,3.96,818,0
0142417424,Paperback,128,2010,2010,3.8,818,0
0439988365,Hardcover,220,2002,2002,3.8,818,0
0374360952,Hardcover,32,2014,2014,3.99,817,0
0811878961,Hardcover,40,2011,2011,3.96,817,0
1423118979,Hardcover,32,2010,2010,4.08,817,0
1554532876,Hardcover,32,2008,2008,4.05,817,0
0810983214,Hardcover,32,2009,2009,3.94,815,0
0375836012,Hardcover,36,2006,2006,4.03,814,0
0140502181,Paperback,48,1964,1977,4.03,813,13
141699081X,Hardcover,81,2009,2009,3.84,812,0
1250051509,Hardcover,32,2016,2016,4.22,811,0
0805093842,Hardcover,40,2011,2012,4.07,811,1
0375973648,Hardcover,40,2018,2018,4.05,809,0
0061142913,Hardcover,34,2012,2012,3.58,809,0
0545485088,Paperback,160,2006,2013,3.8,809,7
0316005096,Hardcover,48,2008,2008,4.24,808,0
1481405330,Ebook,40,2014,2014,3.89,807,0
0531070549,Paperback,48,1991,1994,4.13,807,3
0395361710,Paperback,48,1979,1984,4.2700000000000005,806,5
0545859190,Hardcover,40,2018,2018,4.25,805,0
1484717988,Hardcover,32,2016,2016,4.13,805,0
1419725297,Hardcover,40,2017,2017,4.36,804,0
069811633X,Paperback,32,1993,1999,4.24,804,6
0399160493,Hardcover,32,2016,2016,3.59,803,0
1368024572,Hardcover,96,2018,2018,4.01,802,0
1911171534,Hardcover,40,2018,2018,4.47,801,0
1101999209,Hardcover,40,2016,2017,4.05,801,1
1559707259,Hardcover,32,2005,2005,3.94,801,0
0440417708,Paperback,32,2001,2003,3.86,801,2
1338029479,Hardcover,192,2018,2018,4.14,801,0
0062424335,Hardcover,40,2018,2018,3.85,800,0
148144669X,Hardcover,56,2017,2017,4.18,800,0
0618432507,Hardcover,32,2004,2004,4.15,800,0
0803733941,Hardcover,32,2011,2011,3.89,799,0
0316691313,Hardcover,32,2011,2011,4.21,799,0
0753452545,Paperback,24,1999,1999,4.24,799,0
0811877159,Hardcover,40,2010,2010,3.93,796,0
0735227772,Hardcover,29,2015,2015,4.07,795,0
0823400913,Hardcover,32,1964,1964,3.76,795,0
1590170482,Hardcover,314,1955,2005,4.04,795,50
1423624742,Board Book,22,2012,2012,4.119999999999999,794,0
0517709163,Hardcover,32,2008,2008,3.79,794,0
0547215665,Hardcover,32,2011,2011,4.3,793,0
0375826432,Hardcover,36,1970,2003,4.45,793,33
0805054677,Paperback,64,1962,1997,4.39,792,35
0762462477,Hardcover,40,2018,2018,3.94,791,0
0547733941,Hardcover,32,2015,2015,3.77,791,0
0763566616,Paperback,16,2000,2000,3.88,791,0
0547558635,Hardcover,32,2012,2012,3.92,790,0
0375839356,Hardcover,159,2008,2008,4.22,790,0
0805072659,Hardcover,40,2006,2006,3.71,789,0
1933662077,Hardcover,72,1962,2006,4.37,789,44
0399254692,Hardcover,40,2013,2013,3.94,787,0
0399162909,Hardcover,40,2019,2019,4.54,787,0
076366247X,Hardcover,40,2012,2012,4.1899999999999995,787,0
1453220135,Ebook,32,2009,2011,3.94,787,2
039916913X,Hardcover,32,2016,2016,4.21,786,0
0763669512,Hardcover,32,2014,2014,3.89,786,0
0152438173,Paperback,32,1980,1980,4.2,786,0
0439925444,Hardcover,32,2009,2009,4.14,785,0
0140303499,Paperback,173,1967,1973,3.74,785,6
1452172781,Hardcover,40,2019,2019,3.57,784,0
1423111001,Hardcover,48,2008,2008,3.9,784,0
0805071628,Paperback,32,1998,2002,3.78,784,4
0763665967,Hardcover,48,2018,2018,4.08,782,0
0399551859,Hardcover,40,2017,2017,4.2,782,0
0590441124,Paperback,224,1974,1989,4.03,781,15
162672136X,Hardcover,40,2016,2016,3.55,779,0
0689803818,Paperback,48,1980,1996,3.75,779,16
0316376590,Hardcover,40,2016,2016,3.81,778,0
0553511548,Hardcover,32,2016,2016,4.11,777,0
0763623784,Hardcover,32,2007,2007,3.93,777,0
0152050825,Hardcover,40,2006,2006,3.91,777,0
0689830548,Hardcover,32,1980,1999,4.39,777,19
0374311145,Hardcover,32,1990,1990,4.26,777,0
0803739060,Hardcover,40,2013,2013,3.98,776,0
0140548130,Paperback,32,1988,1992,4.1,776,4
0375869247,Hardcover,32,2014,2014,3.94,775,0
0062377000,Hardcover,32,2016,2016,3.88,774,0
069001287X,Hardcover,28,1975,1977,4.08,774,2
1416985824,Hardcover,40,2016,2016,3.93,773,0
0152253858,Hardcover,48,1900,1983,4.02,773,83
0544947339,Hardcover,32,2017,2017,4.15,772,0
015204969X,Hardcover,32,2011,2011,3.98,771,0
1250107148,Hardcover,32,2017,2017,4.44,770,0
0060239328,Hardcover,64,1969,1969,4.1499999999999995,770,0
0595092969,Paperback,200,1945,2000,4.39,770,55
0230704255,Hardcover,32,2011,2011,3.47,769,0
1459809572,Board Book,24,2016,2016,4.23,768,0
0805086838,Hardcover,32,2010,2010,4.11,767,0
1592700845,Hardcover,32,2005,2009,4.25,767,4
1481420496,Hardcover,32,2018,2018,4.2,766,0
0385390807,Hardcover,40,2015,2015,4.02,766,0
1623706513,Hardcover,32,2016,2016,3.74,765,0
0552547085,Paperback,32,2003,2004,4.46,764,1
0721402712,Paperback,52,1920,1981,3.94,763,61
148470813X,Hardcover,32,2015,2015,4.1499999999999995,761,0
1481442252,Hardcover,32,2016,2016,3.93,760,0
1580892787,Hardcover,40,2011,2011,3.94,760,0
0316939927,Hardcover,80,2001,2006,4.38,760,5
1582461473,Paperback,32,2005,2005,4.3,760,0
1561459380,Hardcover,32,2019,2019,4.26,759,0
0375869735,Hardcover,40,2012,2012,4.25,759,0
0545065704,Hardcover,32,2008,2009,3.84,759,1
1582405263,Paperback,144,2005,2005,3.96,759,0
0823404544,Hardcover,32,1982,1982,4.29,759,0
1442496738,Hardcover,40,2015,2015,3.75,758,0
1580087930,Hardcover,144,1990,2006,4.06,758,16
0689807686,Paperback,32,1996,1996,4.1,758,0
0192798650,Hardcover,32,1982,1982,4.29,758,0
0803733984,Hardcover,32,2012,2012,3.77,756,0
0064432696,Paperback,31,1973,1973,4.13,756,0
0525428372,Hardcover,40,2016,2016,3.72,755,0
0375961062,Hardcover,24,2008,2010,3.84,755,2
0938317776,Hardcover,40,2006,2006,4.25,755,0
1452129363,Hardcover,40,2016,2016,4.12,754,0
054535370X,Hardcover,24,2010,2011,4.08,754,1
0698115929,Paperback,32,1997,1997,4.22,753,0
0544340825,Hardcover,48,2015,2015,3.9,749,0
0803709692,Hardcover,32,1991,1991,4.04,749,0
0761461841,Hardcover,32,2012,2012,3.93,747,0
1933617837,Paperback,183,2007,2007,3.96,747,0
0807536555,Hardcover,32,1993,1993,4.25,746,0
0689713711,Paperback,32,1972,1990,4,746,18
1442412674,Hardcover,48,2014,2014,4.08,745,0
0394891341,Paperback,32,1987,1987,3.85,745,0
1419719076,Hardcover,192,2016,2016,3.8,745,0
0375973265,Hardcover,32,2014,2014,4.08,745,0
0590100548,Hardcover,40,1997,1997,4.28,744,0
0399207481,Hardcover,32,1980,1980,4.42,744,0
0064433064,Paperback,32,1989,1999,3.93,742,10
1452125511,Hardcover,44,2013,2014,3.85,741,1
0763690791,Hardcover,32,2016,2016,3.58,740,0
076361775X,Hardcover,32,2005,2005,4.06,740,0
006051096X,Hardcover,32,2004,2004,4.06,740,0
0761362150,Ebook,40,2011,2011,3.95,739,0
006058307X,Hardcover,288,2005,2006,3.88,739,1
0571206409,Paperback,295,1948,2000,4.13,739,52
1524739057,Hardcover,40,2017,2017,4.02,737,0
0970739923,Hardcover,48,1965,2005,4.67,737,40
0062846795,Hardcover,42,2019,2019,4.34,736,0
0805081127,Paperback,32,2002,2006,3.82,736,4
0399165339,Hardcover,32,2013,2013,3.48,735,0
0670062979,Hardcover,40,2008,2008,4.119999999999999,735,0
0062290037,Hardcover,48,2014,2014,3.72,734,0
1590172027,Hardcover,242,1908,2006,3.92,734,98
0316465674,Hardcover,40,2018,2018,4.1,733,0
1492309532,Paperback,28,2013,2013,4.05,733,0
1554537010,Hardcover,32,2012,2012,3.94,733,0
0152061150,Paperback,32,2002,2007,3.93,733,5
0843174781,Paperback,32,1999,1999,3.87,733,0
0805059113,Hardcover,24,1987,1998,3.88,733,11
0152008918,Paperback,44,1994,1994,4.24,733,0
0805011684,Paperback,32,1987,1989,3.88,733,2
1607062771,Paperback,200,2010,2010,4.02,733,0
1481422952,Ebook,40,2014,2014,4.1899999999999995,732,0
177049538X,Hardcover,32,2013,2013,3.92,732,0
0439719623,Hardcover,32,2007,2007,3.85,732,0
068985837X,Hardcover,32,2006,2006,3.64,732,0
0590921622,Paperback,32,1997,1997,4,732,0
0060543124,Paperback,40,1816,2004,4.02,732,188
0545462630,Hardcover,48,2013,2013,3.88,730,0
1442412917,Hardcover,32,2011,2011,4.01,730,0
0140503935,Paperback,40,1969,1982,4.02,729,13
0375857087,Hardcover,40,2009,2009,4.06,728,0
039591910X,Paperback,24,1972,1998,4.02,728,26
1595309144,Kindle Edition,17,2011,2013,4.07,727,2
1906250219,Hardcover,32,2008,2008,4,727,0
0618140948,Hardcover,32,2004,2004,4.33,726,0
0375844481,Hardcover,40,2012,2012,3.94,725,0
1484723406,Hardcover,32,2016,2016,4.15,724,0
076365549X,Hardcover,108,2012,2012,4.23,724,0
0062360140,Hardcover,32,2016,2016,3.8,723,0
0375837450,Hardcover,34,2008,2008,3.91,723,0
0374374287,Hardcover,40,2009,2009,4,722,0
1632152266,Paperback,128,2015,2015,3.84,722,0
0810988372,Hardcover,208,2010,2010,4.07,722,0
0374300372,Hardcover,40,2015,2015,3.9,721,0
1905417373,Hardcover,32,2007,2007,3.89,720,0
0062012487,Hardcover,32,2012,2012,4,719,0
015205992X,Hardcover,32,2008,2008,3.93,718,0
034538332X,Paperback,126,1993,1993,4.23,718,0
0140505806,Paperback,32,1985,1987,4.2,717,2
142317111X,Hardcover,40,2014,2014,3.81,716,0
0735841918,Hardcover,32,1844,2014,3.85,716,170
1847388752,Hardcover,32,2012,2012,4.2,716,0
1484730461,Hardcover,40,2017,2017,3.65,715,0
1416911790,Hardcover,56,1955,2011,4.01,715,56
0763656968,Hardcover,32,2014,2014,3.53,714,0
1442483210,Hardcover,40,2015,2015,3.87,713,0
0544944801,Hardcover,48,2017,2017,3.83,712,0
0688179614,Hardcover,40,1990,2001,4.09,712,11
0345441095,Paperback,96,2000,2000,4.29,712,0
0374301239,Hardcover,32,2018,2018,4.13,711,0
1442450711,Hardcover,40,2015,2015,3.68,711,0
0399256660,Hardcover,32,2012,2012,4.03,711,0
0152054103,Hardcover,40,2007,2007,3.77,711,0
0971216967,Paperback,176,2006,2006,4.2700000000000005,711,0
1101932813,Hardcover,32,2016,2016,4.13,710,0
1626721777,Hardcover,40,2017,2017,4.119999999999999,708,0
0060080957,Hardcover,40,2004,2007,4.06,708,3
0060272376,Hardcover,40,1996,1996,3.97,708,0
1250156769,Hardcover,32,2016,2016,4.3,707,0
1442480904,Hardcover,48,2015,2015,4.18,707,0
0547249705,Hardcover,32,2010,2010,3.92,707,0
0140555838,Paperback,40,1996,1999,4,707,3
1433807904,Hardcover,32,2009,2010,4.55,707,1
0763689793,Ebook,36,2018,2018,3.81,706,0
1423171101,Hardcover,32,2014,2014,3.79,706,0
0439774977,Hardcover,40,2009,2009,4.13,706,0
0763627755,Hardcover,128,1982,2006,3.64,706,24
039923618X,Hardcover,32,2002,2002,3.93,705,0
0152163980,Paperback,36,1997,2001,4.09,704,4
1554981387,Hardcover,32,2013,2013,4.08,704,0
0747576750,Hardcover,128,1964,2005,3.76,703,41
1442405988,Hardcover,40,2010,2010,3.51,702,0
0099461811,Paperback,32,1995,1998,4.1899999999999995,702,3
0375936157,Hardcover,32,2019,2019,4.44,701,0
0762457813,Hardcover,32,2016,2016,4.38,701,0
1590020499,Paperback,44,1961,2003,4.1,701,42
0531085996,Hardcover,32,1992,1992,4.07,701,0
014050978X,Paperback,64,1963,1989,4.1,701,26
0062050842,Hardcover,43,1964,1997,4.24,700,33
0399236023,Hardcover,32,2002,2002,4.09,698,0
0375866485,Hardcover,40,2017,2017,3.78,697,0
1930900139,Hardcover,173,1957,2001,4.23,697,44
0375840028,Hardcover,40,2009,2009,3.92,696,0
0020430906,Paperback,32,1932,1971,3.92,696,39
068983621X,Hardcover,80,1959,2001,4.05,695,42
0887764371,Paperback,24,1993,1998,4.13,695,5
1481444026,Hardcover,32,2016,2016,3.82,694,0
0307931617,Paperback,96,2013,2014,4.119999999999999,694,1
0374400032,Paperback,160,1993,2006,3.85,694,13
1481459163,Hardcover,40,2016,2016,4.23,693,0
1481452495,Hardcover,40,2016,2016,4.02,692,0
0763680060,Hardcover,24,2015,2015,3.88,692,0
0399256539,Hardcover,32,2011,2011,3.93,692,0
0142500615,Paperback,32,2001,2003,3.86,691,2
0375864482,Paperback,96,2012,2012,4.02,691,0
076364756X,Hardcover,32,2011,2011,4.05,690,0
0763627283,Hardcover,48,2006,2006,4.1,690,0
0689819862,Board Book,10,1987,1999,3.79,690,12
0688080286,Hardcover,32,1989,1989,3.76,690,0
0375814442,Hardcover,48,1940,2001,4,689,61
0747560838,Hardcover,32,1958,2002,4.22,689,44
1452132607,Hardcover,40,2016,2016,4,688,0
1442480882,Hardcover,48,2013,2014,4.06,688,1
0449817415,Hardcover,32,2013,2013,3.72,687,0
0439569842,Paperback,8,2003,2003,3.87,687,0
1524715476,Hardcover,40,2017,2017,4.319999999999999,686,0
0545726069,Hardcover,32,2014,2014,3.95,686,0
0763617164,Hardcover,32,2002,2002,4.11,686,0
0802737331,Hardcover,40,2014,2014,3.64,685,0
0385753977,Hardcover,40,2016,2016,4.25,684,0
0763654086,Hardcover,32,2012,2012,3.6,684,0
0374351015,Hardcover,32,2000,2001,3.87,683,1
0399254269,Hardcover,208,2011,2011,3.87,683,0
0763649546,Hardcover,24,2010,2010,4.07,682,0
1405020482,Paperback,27,2004,2005,4,682,1
0670035041,Hardcover,40,1972,2001,3.88,682,29
0345416716,Paperback,128,1997,1997,4.22,682,0
0399226583,Hardcover,32,1995,1995,3.87,681,0
0060291559,Hardcover,32,2011,2011,4.17,680,0
0439495245,Hardcover,32,2004,2004,3.74,680,0
0142407208,Paperback,160,1987,2006,4.06,680,19
059043974X,Hardcover,160,1988,1988,4.05,679,0
1419725599,Hardcover,48,2017,2017,4.42,678,0
1930900201,Hardcover,32,1960,2002,4.1899999999999995,678,42
160469727X,Hardcover,390,2017,2017,4,677,0
0449814114,Hardcover,32,2013,2013,3.8,677,0
0439578442,Hardcover,32,2003,2004,4.19,677,1
073526354X,Hardcover,34,2019,2019,4.25,676,0
0399162836,Hardcover,32,2014,2014,4.04,676,0
0152050647,Paperback,40,1993,2004,3.67,676,11
1101935928,Hardcover,256,2019,2019,4.25,676,0
1926973771,Hardcover,32,2011,2013,3.76,675,2
0803728506,Hardcover,32,2005,2005,4.38,675,0
0385306970,Hardcover,40,1992,1992,4.109999999999999,675,0
039552024X,Hardcover,32,1991,1991,4.119999999999999,675,0
0553510231,Hardcover,32,2016,2016,3.98,674,0
0810997355,Hardcover,48,2011,2011,4.07,674,0
0982993803,Hardcover,24,2010,2010,4.39,674,0
0545751403,Hardcover,32,2013,2013,4.02,673,0
1423136942,Hardcover,32,2010,2011,3.89,673,1
0763616990,Hardcover,40,2004,2004,4.1,673,0
0374399182,Hardcover,32,2008,2008,4.23,672,0
157542200X,Board Book,24,2002,2002,4.1499999999999995,672,0
1250112494,Hardcover,32,2017,2017,4.35,671,0
1454904364,Hardcover,40,2014,2014,4.15,671,0
1847384366,Paperback,16,2010,2010,3.7,671,0
0811807185,Hardcover,32,1995,1996,4.14,671,1
059047782X,Paperback,32,1994,1994,3.9,671,0
0399250956,Hardcover,32,2009,2009,4.04,671,0
1595325999,Paperback,176,2005,2005,3.71,671,0
1459802489,Board Book,24,2013,2013,4.29,670,0
0689866801,Paperback,32,2001,2004,4.2700000000000005,669,3
0763668419,Hardcover,48,2016,2016,4.17,668,0
1442498978,Hardcover,32,2014,2014,3.84,668,0
144242141X,Hardcover,32,2011,2011,3.83,668,0
0698114019,Paperback,32,1987,1996,3.83,668,9
0670013978,Hardcover,40,2018,2018,3.95,667,0
031264521X,Hardcover,32,2011,2011,4.21,667,0
0439698359,Hardcover,48,2009,2009,4.17,666,0
0763692654,Hardcover,40,2017,2017,4.01,665,0
0060289007,Hardcover,32,2001,2001,3.77,665,0
155453416X,Hardcover,112,2011,2011,4.04,664,0
1905417691,Hardcover,32,2008,2008,3.8,663,0
0140568166,Paperback,40,1998,2001,4.07,663,3
0698114280,Paperback,32,1992,1997,4.11,663,5
1416909168,Hardcover,64,1999,2006,4,663,7
0399250182,Hardcover,32,2008,2008,3.94,662,0
1481416006,Hardcover,40,2016,2016,3.97,661,0
0399256024,Hardcover,40,2012,2012,4.08,661,0
0142300926,Paperback,32,1998,2002,4.26,661,4
1401262473,Paperback,128,2016,2016,3.91,661,0
0689817088,Paperback,64,1998,2000,4.06,661,2
0735227918,Hardcover,40,2018,2018,3.99,660,0
0670062456,Hardcover,32,2008,2008,4.02,660,0
0448424975,Paperback,112,2002,2002,4.1499999999999995,660,0
0670785741,Hardcover,40,2015,2015,3.58,659,0
3794151089,Hardcover,32,2006,2006,4.09,659,0
0375982191,Ebook,32,2013,2013,3.93,658,0
0671667440,Paperback,48,1970,1988,4.28,658,18
0395620376,Hardcover,32,1993,1993,4.03,657,0
0888999755,Hardcover,34,2011,2011,3.91,657,0
0763630543,Hardcover,56,2007,2007,3.98,657,0
1452112428,Hardcover,36,2016,2016,3.9,656,0
0803737890,Hardcover,32,2014,2014,3.83,656,0
1401252427,Paperback,128,2015,2015,4.2700000000000005,656,0
1606995359,Hardcover,240,2012,2012,4.52,655,0
0375869220,Hardcover,48,2011,2011,4.35,654,0
0807566667,Paperback,32,2000,2000,4.18,654,0
1452141983,Hardcover,32,2014,2015,3.94,653,1
076362201X,Hardcover,40,2003,2003,4.15,653,0
1848862237,Paperback,32,2016,2016,3.58,652,0
0670061360,Hardcover,32,2008,2008,4,652,0
0553497820,Hardcover,32,2016,2016,3.64,651,0
0316254436,Hardcover,40,2015,2015,4.09,651,0
0670062758,Hardcover,32,2008,2008,3.82,650,0
0803725140,Hardcover,32,2001,2001,4.31,650,0
0399255214,Paperback,128,2012,2012,3.98,649,0
1939547202,Hardcover,40,2015,2015,4.1899999999999995,648,0
076363588X,Hardcover,32,2009,2009,3.79,648,0
0763607177,Paperback,48,1901,1999,4.18,648,98
0399207473,Hardcover,32,1980,1980,4.470000000000001,648,0
014150059X,Paperback,32,2007,2007,3.88,647,0
054539127X,Hardcover,208,2012,2012,4.05,647,0
1481441396,Hardcover,32,2017,2017,3.69,646,0
0140566651,Paperback,31,1990,2000,4.109999999999999,646,10
0553511505,Hardcover,40,2016,2016,3.74,645,0
0670785733,Hardcover,40,2014,2014,3.68,645,0
0689858094,Hardcover,32,2009,2009,3.88,645,0
0803736789,Hardcover,208,2012,2012,4.319999999999999,645,0
0803735766,Hardcover,32,2010,2011,3.88,644,1
0399250778,Hardcover,96,2009,2009,4.45,644,0
0374403821,Paperback,32,1931,1997,4.159999999999999,644,66
0345392876,Paperback,128,1995,1995,4.25,644,0
1442423277,Hardcover,40,2015,2015,3.49,643,0
0823422801,Hardcover,32,2010,2010,3.78,643,0
014054240X,Paperback,32,1989,1991,4.18,643,2
0544387619,Hardcover,32,2017,2017,3.8,642,0
0763675423,Hardcover,32,2017,2017,4.02,642,0
0525429158,Hardcover,88,2015,2015,4.34,642,0
0803735820,Hardcover,40,2012,2012,4.1,642,0
0689716885,Paperback,32,1971,1993,3.77,642,22
068816241X,Hardcover,32,2000,2000,4,641,0
1454913452,Hardcover,32,2015,2015,4.12,640,0
0670785784,Hardcover,40,2015,2015,3.35,640,0
1559332344,Hardcover,30,1998,1998,4.08,640,0
1627795103,Hardcover,32,2017,2017,3.94,639,0
0061692867,Hardcover,40,2012,2012,3.91,639,0
0375869441,Hardcover,48,2012,2012,3.97,639,0
0439877563,Hardcover,48,2007,2007,4.21,639,0
1616556218,Hardcover,80,2015,2015,4.33,639,0
076368953X,Hardcover,48,2017,2017,3.89,638,0
162370426X,Hardcover,42,2015,2015,4.42,638,0
0375845003,Hardcover,40,2007,2009,4.26,638,2
1416989722,Hardcover,96,2010,2011,4.14,638,1
0061915165,Hardcover,40,2012,2012,3.62,637,0
1416928340,Hardcover,32,2008,2008,3.84,637,0
0307122581,Board Book,12,1981,1995,4.48,637,14
1416995447,Hardcover,40,2011,2011,3.65,636,0
1416953418,Hardcover,40,2009,2009,3.72,636,0
068987040X,Hardcover,80,2005,2005,4.02,636,0
0152062947,Hardcover,40,2015,2015,4.17,634,0
142316721X,Hardcover,48,2014,2014,3.83,634,0
0374380449,Hardcover,36,2006,2006,4.24,633,0
0399556133,Hardcover,208,2017,2017,3.8,633,0
0375836063,Hardcover,40,2008,2008,3.6,633,0
1927095778,Hardcover,32,2013,2014,4.21,632,1
0439709873,Paperback,112,2005,2005,3.81,632,0
0397316089,Hardcover,191,1975,1975,4.37,632,0
0399245073,Hardcover,32,2010,2010,3.85,631,0
0062367242,Hardcover,40,2014,2015,3.83,630,1
0763665010,Hardcover,40,2014,2014,3.89,630,0
0064401472,Paperback,104,1966,1984,3.93,630,18
0439724171,Hardcover,32,2009,2009,4.14,629,0
0062393391,Hardcover,40,2017,2017,3.91,628,0
0316376612,Hardcover,40,2017,2017,3.68,628,0
0316122351,Hardcover,32,2012,2012,3.98,628,0
0439352436,Hardcover,48,1998,2002,4.21,628,4
0763649902,Hardcover,40,2012,2012,4.1,627,0
0394827058,Paperback,24,1973,1997,4.3,626,24
0399252304,Hardcover,32,2010,2010,3.86,625,0
1400071755,Hardcover,32,2006,2006,4.38,625,0
0732291712,Hardcover,32,2011,2011,3.99,624,0
0316036749,Hardcover,32,2009,2010,3.83,624,1
0385325851,Paperback,96,1996,1998,4.13,624,2
1481471627,Hardcover,40,2016,2016,3.75,623,0
1939547156,Hardcover,32,2015,2015,4.15,623,0
0062198734,Hardcover,32,2014,2014,3.36,623,0
082341602X,Hardcover,32,2011,2011,3.86,622,0
1416971122,Hardcover,32,2008,2008,3.88,622,0
0525479325,Hardcover,24,2007,2008,4.08,622,1
0316181013,Hardcover,32,2012,2012,4.05,621,0
0803733283,Hardcover,48,2008,2008,3.91,621,0
0670036471,Hardcover,48,2003,2003,4.23,621,0
1452165955,Hardcover,40,2018,2018,4.2,620,0
1481470310,Hardcover,40,2016,2016,3.64,620,0
0823425193,Hardcover,32,2012,2012,4.11,620,0
1484730453,Hardcover,40,2016,2016,3.43,619,0
1442480920,Hardcover,32,2015,2015,3.89,619,0
0439148928,Hardcover,40,2000,2000,4.42,619,0
0763670022,Hardcover,32,2015,2015,4.05,618,0
085763089X,Hardcover,32,2013,2013,3.71,618,0
0811844307,Hardcover,36,2005,2005,4.01,618,0
0152047603,Paperback,44,2002,2003,4.28,618,1
0394810163,Hardcover,40,1968,1968,3.87,618,0
0689835302,Paperback,32,1983,2000,4.08,618,17
0525690611,Board Book,16,1983,1995,4.08,617,12
0060220732,Hardcover,32,1967,1967,4.159999999999999,617,0
0062699458,Hardcover,40,2018,2018,4.470000000000001,616,0
0374311013,Board Book,32,1989,1992,4.2,616,3
0689852185,Hardcover,40,2003,2003,4.38,616,0
0060270268,Hardcover,32,1952,1952,3.83,616,0
0553509128,Hardcover,40,2016,2016,3.82,615,0
0399254439,Hardcover,32,2009,2009,4.319999999999999,615,0
0061130974,Hardcover,32,2008,2008,3.82,615,0
0374302936,Hardcover,40,2016,2016,3.96,614,0
0399242473,Hardcover,32,2005,2005,3.86,614,0
1463590857,Paperback,94,1922,2011,4.119999999999999,614,89
0316394289,Hardcover,40,2018,2018,4.21,611,0
0805099662,Hardcover,32,2013,2014,3.82,611,1
0763669911,Hardcover,32,2014,2014,4.17,610,0
0694011673,Board Book,34,1986,1998,3.84,610,12
068971677X,Paperback,214,1959,1993,4.2,610,34
0803734468,Hardcover,32,2009,2009,3.66,609,0
0590100416,Hardcover,40,2001,2001,3.9,609,0
159307719X,Paperback,237,1998,2007,4.1499999999999995,609,9
0375855475,Paperback,32,1957,2010,4.03,608,53
0618356541,Hardcover,32,2004,2004,3.98,608,0
1593690169,Paperback,128,2005,2005,3.93,607,0
1596434422,Hardcover,32,2009,2009,3.85,606,0
0887769039,Paperback,120,2009,2009,3.4,606,0
1101919256,Hardcover,36,2019,2019,4.18,605,0
0763692964,Hardcover,40,2016,2016,3.73,605,0
0375968474,Hardcover,40,2011,2011,3.76,605,0
0399254358,Hardcover,32,2010,2010,4.21,605,0
1416909087,Hardcover,40,1999,2007,3.88,605,8
1770494499,Hardcover,32,2013,2014,3.71,604,1
0316820164,Hardcover,32,2000,2000,3.87,604,0
0060787651,Hardcover,40,2008,2008,3.97,603,0
0761317899,Hardcover,32,2003,2003,3.91,603,0
1419716506,Hardcover,40,2015,2015,3.85,602,0
0763640557,Hardcover,32,2012,2012,4.04,602,0
1416995250,Hardcover,120,2010,2010,3.3899999999999997,602,0
0823430502,Hardcover,24,2014,2014,4.11,601,0
1442406194,Hardcover,32,2011,2011,3.68,601,0
0590462229,Paperback,96,1968,1993,3.91,601,25
0307004627,Hardcover,24,1991,1995,4.21,599,4
0006916201,Paperback,192,1967,1985,4.13,599,18
0062373307,Hardcover,40,2018,2018,4.35,598,0
0152024743,Paperback,44,2000,2001,4.34,597,1
0140503854,Paperback,28,1983,1984,3.9,596,1
0061566349,Hardcover,40,2011,2011,3.88,595,0
141699839X,Hardcover,32,2010,2010,4.18,595,0
1556437854,Hardcover,48,2009,2009,4.25,595,0
0316228869,Hardcover,40,2014,2014,4.04,594,0
0590551752,Paperback,32,1977,1994,4.06,594,17
0385383975,Hardcover,40,2015,2015,3.95,593,0
0689855842,Board Book,34,2000,2003,3.78,593,3
0345373685,Paperback,128,1991,1991,4.2,593,0
1419701703,Hardcover,32,2009,2012,3.72,592,3
0060253754,Hardcover,32,2008,2008,4.2700000000000005,592,0
0062307835,Hardcover,32,2015,2015,4.13,591,0
1250043271,Hardcover,40,2014,2014,3.79,591,0
0984681434,Paperback,101,2013,2013,3.64,591,0
073522854X,Hardcover,40,2018,2018,3.64,590,0
148147684X,Hardcover,48,2018,2018,4.24,590,0
076366555X,Hardcover,40,2015,2015,4.2,590,0
1416927530,Hardcover,32,2014,2014,3.96,589,0
0525475753,Hardcover,32,2006,2006,3.93,589,0
0843178396,Paperback,32,1978,1998,3.95,589,20
0679870784,Hardcover,367,1994,1994,4.39,589,0
0062287362,Hardcover,40,2014,2014,3.66,588,0
1402770766,Hardcover,26,2010,2010,3.98,588,0
0688170625,Paperback,32,1994,1999,4.1899999999999995,588,5
0345412419,Paperback,128,1997,1997,4.22,588,0
0152002421,Paperback,44,2004,2005,4.26,587,1
0786803185,Hardcover,32,1997,1997,4.14,587,0
0689811624,Hardcover,64,1977,1996,4.46,587,19
1454913932,Hardcover,32,2016,2016,4.04,585,0
1481456563,Hardcover,32,2016,2016,3.85,585,0
0062102990,Hardcover,32,2013,2013,3.89,585,0
0545085985,Hardcover,32,2010,2010,3.87,585,0
054510145X,Hardcover,32,2009,2009,3.62,585,0
0439845025,Paperback,108,2000,2006,4.42,585,6
0863151639,Hardcover,32,1932,1993,4.31,585,61
0064400247,Hardcover,247,1955,1966,4.18,585,11
1627794166,Hardcover,32,2017,2017,3.99,584,0
0803739443,Hardcover,40,2016,2016,3.8,584,0
0803739117,Hardcover,40,2015,2015,3.87,584,0
0316045489,Hardcover,40,2009,2009,4.14,584,0
0007171358,Paperback,32,1976,2004,4.25,584,28
0399250069,Hardcover,32,2009,2009,3.92,584,0
148148740X,Hardcover,40,2019,2019,4.24,583,0
0805089373,Hardcover,32,2010,2010,3.88,583,0
068984882X,Paperback,80,2002,2003,4.1899999999999995,583,1
1419709364,Board Book,104,2013,2013,4.38,582,0
1419701770,Hardcover,40,2012,2012,3.92,582,0
1416940057,Hardcover,32,2010,2010,3.7,582,0
1941302726,Hardcover,32,2018,2018,3.94,581,0
0140546499,Paperback,32,1973,1993,3.98,581,20
0763681067,Hardcover,48,2014,2015,3.76,580,1
0670013153,Hardcover,40,2014,2014,3.77,580,0
0786941642,Hardcover,80,2006,2006,4.33,580,0
0689847882,Hardcover,32,2004,2004,3.95,580,0
0060244003,Hardcover,32,1940,1968,3.79,580,28
1452141975,Hardcover,60,2016,2016,3.87,579,0
0066236207,Hardcover,32,2004,2004,4.13,579,0
076368824X,Hardcover,32,2017,2017,3.69,578,0
0803738463,Hardcover,208,2013,2013,4.33,578,0
0394842502,Hardcover,48,1979,1979,4.26,578,0
0763695718,Hardcover,40,2017,2017,4.09,577,0
0316400815,Hardcover,40,2015,2015,3.8,577,0
0061804363,Hardcover,40,2013,2013,3.84,577,0
0735842086,Hardcover,26,2015,2015,3.77,577,0
0803741707,Hardcover,32,2015,2015,3.78,576,0
0794508189,Board Book,10,2004,2004,4.1,576,0
145214401X,Hardcover,40,2017,2017,3.29,575,0
0141502398,Paperback,32,2011,2011,3.87,575,0
0439523494,Paperback,32,2002,2004,3.95,575,2
0843138238,Paperback,32,1987,1995,4.26,575,8
1561485101,Hardcover,28,2001,2013,4.159999999999999,575,12
1546328017,Kindle Edition,58,2017,2017,4.3,574,0
1423143299,Hardcover,32,2011,2012,3.8,574,1
0803732228,Hardcover,32,2011,2011,3.85,573,0
0689868049,Hardcover,32,2005,2005,3.78,573,0
0714865354,Hardcover,46,2012,2013,3.55,573,1
0803731930,Board Book,16,2008,2008,4,572,0
0439458684,Hardcover,32,2004,2004,3.95,572,0
0525427740,Hardcover,96,2015,2015,4.1499999999999995,571,0
1931686874,Paperback,224,2004,2004,4.08,571,0
0803739850,Hardcover,229,2016,2016,4.28,571,0
0439313279,Paperback,32,1987,2001,4.28,571,14
0375870369,Hardcover,40,2014,2014,3.71,570,0
0805037624,Hardcover,32,1997,1997,3.83,570,0
0316547697,Hardcover,34,2018,2018,3.97,569,0
1419710354,Hardcover,32,2014,2014,3.87,569,0
1429925523,Ebook,55,2009,2009,4.109999999999999,569,0
0394924924,Hardcover,36,1972,1972,3.99,569,0
0763670847,Hardcover,32,2016,2016,4.07,568,0
0763651257,Hardcover,32,2013,2013,4.21,568,0
0060575026,Hardcover,32,2006,2006,3.96,568,0
0060281898,Hardcover,32,1954,2005,3.98,568,51
0694009989,Board Book,32,1991,1997,3.94,568,6
0863150926,Hardcover,30,1912,1993,4.29,568,81
0553522434,Hardcover,32,2016,2016,3.99,567,0
3407760140,Paperback,47,1982,2004,4.39,567,22
0545373239,Hardcover,34,2011,2012,4.24,566,1
1563896265,Paperback,181,2000,2000,3.93,566,0
0531059820,Hardcover,48,1992,1992,4.28,566,0
0763658286,Hardcover,40,2017,2017,4.33,565,0
0062335367,Hardcover,40,2015,2015,4.15,565,0
0971216959,Hardcover,176,2004,2006,4.24,565,2
0440444381,Hardcover,154,1966,1966,4.2700000000000005,564,0
0786851414,Hardcover,48,2009,2009,4.34,563,0
1592701493,Hardcover,110,2013,2014,4.26,563,1
1585360694,Hardcover,48,2002,2002,4.35,562,0
0316573957,Hardcover,32,1997,1997,3.94,562,0
0062050141,Hardcover,56,1993,1993,3.8,562,0
015201697X,Paperback,32,1990,1998,4.05,561,8
0395828473,Hardcover,48,1952,1997,3.89,561,45
1250051495,Hardcover,32,2015,2015,3.83,560,0
0805068406,Hardcover,32,2001,2002,3.93,559,1
0689851413,Board Book,34,1999,2002,4.1,559,3
0345464583,Paperback,96,2004,2004,4.31,559,0
0689716052,Paperback,56,1969,1992,4.28,559,23
0545402956,Hardcover,32,2015,2015,3.95,558,0
0064407489,Paperback,186,1966,1999,4.319999999999999,558,33
1580892582,Hardcover,32,2009,2010,4.08,557,1
0688109950,Paperback,32,1982,1993,4.01,557,11
014056196X,Paperback,40,1996,2000,4.22,556,4
0440413478,Paperback,40,1982,1997,4.21,556,15
0140508732,Paperback,32,1987,1989,4.21,556,2
0805007997,Paperback,32,1986,1988,3.84,556,2
1404867880,Board Book,20,2011,2011,3.99,555,0
0099411393,Paperback,464,1992,1992,4.17,555,0
1459814479,Hardcover,18,2017,2017,4.17,554,0
0307982939,Board Book,22,2012,2012,4.13,554,0
0803732554,Hardcover,32,2008,2008,3.6,554,0
0385753772,Ebook,32,2015,2015,3.76,553,0
1444919148,Hardcover,32,2014,2014,3.97,553,0
1452106169,Hardcover,40,2013,2013,3.92,553,0
1416979328,Hardcover,40,2014,2014,3.55,552,0
0062404342,Hardcover,40,2017,2017,3.7,551,0
1481401203,Hardcover,40,2016,2016,4.2700000000000005,551,0
0843176873,Paperback,32,1974,2001,4.18,551,27
0979923824,Hardcover,40,2008,2008,3.72,551,0
0689876858,Paperback,224,2006,2007,3.81,551,1
0802737803,Hardcover,40,2015,2015,3.66,550,0
0152024085,Hardcover,44,2001,2001,4.2700000000000005,550,0
0395643767,Paperback,32,1989,1992,3.77,550,3
1419731610,Hardcover,40,2018,2018,4.109999999999999,549,0
1442422629,Hardcover,48,2013,2013,4.07,549,0
0805090029,Hardcover,32,2011,2011,3.73,549,0
0689878273,Paperback,48,1976,2005,4.1899999999999995,548,29
0316265233,Hardcover,32,2016,2016,3.99,547,0
039925739X,Hardcover,32,2013,2013,3.88,547,0
0152059369,Hardcover,32,2007,2007,3.59,547,0
0375970878,Hardcover,32,2012,2012,3.79,547,0
0689832559,Paperback,176,1997,2000,3.5,547,3
0544472705,Hardcover,40,2016,2016,3.42,546,0
1596430532,Hardcover,32,2007,2007,3.59,546,0
1684460042,Hardcover,32,2018,2018,4.31,546,0
9786067044,Hardcover,40,2017,2017,3.87,546,0
1442422661,Hardcover,32,2014,2014,4.1,545,0
0801013062,Hardcover,70,1994,2007,4.31,545,13
1416912401,Hardcover,32,2007,2007,3.81,545,0
0060517840,Paperback,32,1963,2003,3.99,545,40
0843148721,Paperback,32,1974,2002,4.13,545,28
1481444964,Hardcover,32,2017,2017,3.78,544,0
0763614521,Hardcover,32,2001,2001,4.13,543,0
006443124X,Paperback,48,1982,1986,4.13,543,4
0823422917,Hardcover,32,2011,2011,3.86,542,0
0007540302,Paperback,32,2014,2014,4.24,541,0
1554534690,Hardcover,80,2012,2012,3.8,541,0
2756002879,Hardcover,47,2005,2006,3.89,541,1
1481461524,Hardcover,40,2016,2016,3.45,540,0
1402778627,Hardcover,24,2012,2012,4.109999999999999,540,0
141691627X,Hardcover,40,2007,2007,3.57,540,0
0975958003,Hardcover,32,2005,2005,4.14,539,0
1416986871,Hardcover,32,2012,2012,3.5,538,0
0345397762,Paperback,128,1995,1995,4.2,538,0
0763655295,Hardcover,32,2013,2013,3.9,537,0
0140503285,Paperback,32,1966,1978,3.78,537,12
0763689963,Hardcover,24,2016,2016,4.07,536,0
1423159578,Hardcover,48,2013,2013,3.74,536,0
0060572426,Hardcover,32,2004,2004,3.93,536,0
0152023895,Paperback,44,1998,2000,4.159999999999999,536,2
1606991418,Hardcover,120,1978,2009,4.3,536,31
0152999671,Hardcover,32,1992,1992,3.99,535,0
073584013X,Hardcover,40,2003,2011,3.78,534,8
1416937889,Hardcover,40,2010,2010,3.65,534,0
1596431601,Hardcover,80,2006,2006,4.1899999999999995,534,0
0670061034,Hardcover,32,1986,2006,4.07,534,20
0843104872,Paperback,32,1986,2003,4.24,534,17
1626721068,Hardcover,128,2016,2016,3.77,534,0
1846160421,Hardcover,32,2009,2009,4.06,534,0
0525429166,Hardcover,40,2016,2016,4.14,533,0
0375958940,Hardcover,40,2009,2010,3.82,533,1
0823415139,Paperback,32,1998,1999,3.78,533,1
0763634484,Hardcover,32,2011,2011,3.71,532,0
0062857576,Hardcover,96,2015,2016,3.96,532,1
141695774X,Hardcover,40,2011,2011,4,532,0
1481400975,Hardcover,40,2015,2015,3.5,531,0
1770495681,Hardcover,40,2014,2014,3.78,531,0
1554535033,Hardcover,32,2011,2011,3.93,531,0
0805079033,Hardcover,32,2008,2008,4.109999999999999,531,0
0064434664,Paperback,32,1949,1998,4.109999999999999,531,49
1250054583,Hardcover,40,2016,2016,3.86,530,0
0545829348,Hardcover,40,2016,2016,3.83,530,0
0803734387,Hardcover,40,2014,2014,3.84,530,0
0375839232,Hardcover,24,1977,2007,4.23,530,30
184148119X,Paperback,32,2003,2004,4.24,530,1
1554537770,Paperback,116,2012,2012,4.01,530,0
1481486861,Hardcover,32,2017,2017,3.87,529,0
1760159840,Hardcover,24,2016,2016,3.94,529,0
0689834470,Paperback,40,2005,2006,3.94,529,1
0805073841,Hardcover,32,2005,2005,3.75,529,0
1452113866,Hardcover,448,2015,2015,4.1499999999999995,528,0
0345427491,Paperback,128,1998,1998,4.2,528,0
1596434708,Hardcover,40,2011,2011,4.09,527,0
0140541934,Paperback,48,1990,1993,4.01,527,3
0374380643,Hardcover,32,2011,2011,3.58,526,0
0375829288,Hardcover,224,2005,2005,4.470000000000001,526,0
1481459716,Hardcover,32,2016,2016,3.83,525,0
0060286385,Hardcover,32,1953,2001,3.67,525,48
031632244X,Hardcover,32,2014,2014,3.75,524,0
0805081267,Hardcover,32,2010,2010,3.78,524,0
0230017932,Hardcover,32,2009,2009,3.91,524,0
0553510959,Hardcover,40,2015,2015,3.77,523,0
158089626X,Hardcover,48,2015,2015,4.28,523,0
1452127433,Hardcover,24,2012,2014,3.89,523,2
0312368402,Hardcover,32,2008,2011,3.73,523,3
0763628255,Hardcover,32,2007,2007,3.94,523,0
1452138362,Paperback,128,2016,2016,3.91,523,0
0525514082,Hardcover,40,2018,2018,4.28,522,0
006236412X,Hardcover,40,2016,2016,3.73,522,0
0553512331,Board Book,18,2015,2015,4.06,522,0
0440417686,Paperback,40,2005,2005,3.92,522,0
0316370924,Hardcover,40,2016,2016,3.79,520,0
0786854936,Hardcover,40,2014,2014,3.85,520,0
0618998519,Hardcover,40,2011,2011,3.8,520,0
1935179195,Hardcover,32,2012,2012,3.75,520,0
0399255354,Hardcover,32,2012,2012,3.63,519,0
0689858388,Hardcover,32,2005,2005,3.8,519,0
0316602027,Hardcover,19,1995,1995,4.55,519,0
0374380775,Hardcover,40,2015,2015,4.13,519,0
0345452011,Paperback,96,2003,2003,4.26,519,0
0802737390,Hardcover,40,2016,2016,4.3,518,0
0763671274,Hardcover,32,2014,2014,4.18,518,0
0061804347,Hardcover,40,2011,2011,3.86,518,0
0810989697,Hardcover,32,2010,2010,3.89,518,0
076365311X,Hardcover,34,2012,2012,3.98,517,0
0374316953,Hardcover,40,2016,2016,3.77,516,0
1922077305,Hardcover,32,2014,2014,3.94,516,0
1596436484,Hardcover,32,2012,2012,3.75,516,0
1442408103,Hardcover,40,2012,2012,3.73,516,0
0060586281,Paperback,48,1958,2004,3.88,516,46
0399209948,Hardcover,32,1983,1983,4.38,516,0
1101919078,Hardcover,40,2017,2017,4.34,516,0
141698609X,Paperback,176,2010,2010,4.28,516,0
0823443442,Hardcover,40,2019,2019,3.78,514,0
1492660329,Hardcover,26,2017,2017,4.05,514,0
0590034804,Paperback,32,1998,1998,3.95,514,0
1606997424,Hardcover,208,2014,2014,4.470000000000001,514,0
076369570X,Hardcover,32,2017,2017,4.27,513,0
0399555269,Hardcover,26,2017,2017,3.95,513,0
0688167977,Hardcover,32,2000,2000,3.69,513,0
0679809015,Board Book,22,1993,1993,4.1899999999999995,513,0
0547978995,Hardcover,32,2014,2014,3.94,513,0
148145854X,Hardcover,40,2016,2016,3.88,512,0
0375955836,Hardcover,32,2008,2008,3.92,512,0
0375832173,Hardcover,32,2004,2004,3.78,512,0
0545117178,Paperback,160,2011,2011,4.18,512,0
0300170998,Paperback,77,2011,2011,4.17,512,0
2800100176,Hardcover,63,1961,1986,4.05,512,25
0399233911,Board Book,16,1990,1999,4,511,9
0448446987,Paperback,96,2008,2008,3.99,511,0
0803724144,Hardcover,32,2000,2000,4.31,511,0
0440987903,Paperback,249,1984,1987,4.2700000000000005,511,3
1101918594,Hardcover,48,2019,2019,4.44,510,0
0763679585,Hardcover,40,2014,2015,3.64,510,1
0544748034,Hardcover,32,2016,2016,3.78,509,0
1481430572,Hardcover,40,2015,2015,3.91,509,0
0224080482,Hardcover,192,2007,2007,3.95,509,0
1250134889,Hardcover,36,2018,2018,4.26,508,0
0763639915,Hardcover,40,2012,2012,3.68,508,0
0763639214,Hardcover,24,2008,2008,3.95,508,0
0982093209,Hardcover,243,1946,2008,4.41,508,62
0316588458,Hardcover,32,1997,1997,3.88,508,0
0140500340,Paperback,36,1950,1970,3.95,508,20
0316438081,Hardcover,40,2018,2018,4.359999999999999,507,0
0911104542,Paperback,160,1975,2012,4.18,507,37
0689802463,Hardcover,32,2009,2009,4.01,507,0
1575059304,Hardcover,32,2007,2007,4.1499999999999995,507,0
015216748X,Hardcover,40,2002,2002,3.97,507,0
0749704977,Paperback,33,1950,1991,3.95,507,41
0394800214,Hardcover,62,1961,1961,4.3,507,0
0545609542,Hardcover,40,2015,2015,3.79,506,0
9984378462,Paperback,28,1913,2007,4.13,506,94
081094913X,Hardcover,24,2004,2006,3.97,506,2
0316988944,Hardcover,32,2004,2004,4.07,506,0
0375812350,Hardcover,48,1963,2001,4.1499999999999995,506,38
1629725552,Hardcover,304,2019,2019,3.9,505,0
0399553541,Kindle Edition,24,2016,2016,4.119999999999999,505,0
1524768286,Hardcover,40,2020,2020,4.6899999999999995,504,0
0803740115,Hardcover,32,2015,2015,3.82,504,0
0140506306,Paperback,26,1969,1995,4.1499999999999995,504,26
0361071752,Hardcover,32,1949,1986,4.01,504,37
1481446029,Hardcover,40,2016,2016,3.52,503,0
1250086566,Hardcover,40,2016,2016,4.04,503,0
0689838441,Hardcover,32,2006,2007,3.95,503,1
0689834373,Hardcover,32,2006,2006,3.68,503,0
0345439228,Paperback,128,2000,2000,4.23,503,0
031238243X,Hardcover,40,2010,2010,4.01,502,0
0688133827,Hardcover,40,1998,1998,4.159999999999999,502,0
1401234844,Paperback,192,2012,2012,3.3,502,0
141695029X,Hardcover,28,1982,2007,4.05,502,25
156148475X,Paperback,26,2005,2013,4.1,501,8
0803737122,Hardcover,32,2012,2012,3.73,501,0
1575420775,Paperback,35,2000,2001,4.05,501,1
0694010332,Paperback,24,1998,1998,4.1,501,0
0553507613,Hardcover,32,2014,2014,3.59,500,0
1564582035,Hardcover,64,1993,1993,4.29,500,0
0395282675,Paperback,40,1959,1979,4.23,500,20
1933693061,Hardcover,40,2008,2008,3.8,500,0
0920236936,Paperback,32,1984,1984,3.73,499,0
0156119072,Paperback,32,1979,1979,4.1,499,0
141972875X,Hardcover,56,2018,2018,4.37,498,0
1743361564,Paperback,24,2013,2014,3.78,498,1
1423143302,Hardcover,32,2012,2013,3.94,498,1
0803733747,Hardcover,40,2012,2012,3.84,498,0
014250159X,Paperback,48,2001,2003,4.09,498,2
006444015X,Paperback,64,1958,1978,4.01,498,20
0824955595,Hardcover,32,2007,2012,4.28,497,5
0805061789,Hardcover,32,2000,2000,3.95,497,0
073584156X,Hardcover,48,2008,2015,4.01,497,7
1584850787,Paperback,38,2000,2000,4,497,0
0805092374,Hardcover,40,2011,2011,3.81,496,0
0060539720,Paperback,16,2004,2004,4.09,496,0
0590100793,Hardcover,40,2000,2000,3.7,496,0
0689500211,Hardcover,32,1975,1975,4.430000000000001,496,0
0802854923,Hardcover,42,2017,2017,4.14,495,0
0670011606,Hardcover,40,2010,2010,3.87,495,0
006113094X,Hardcover,61,2009,2010,3.57,495,1
0062302035,Hardcover,40,2015,2015,3.96,494,0
2745942212,Hardcover,46,2010,2010,4.470000000000001,493,0
1591161819,Paperback,224,2000,2003,3.79,493,3
1419725327,Hardcover,32,2017,2017,4.109999999999999,492,0
0733334350,Hardcover,32,2015,2015,3.95,492,0
0763664316,Hardcover,32,2012,2012,3.93,492,0
0698119657,Paperback,40,1999,2002,4.22,492,3
1558584285,Hardcover,32,1841,1995,3.59,492,154
1760158518,Hardcover,32,2016,2016,3.55,491,0
0374301212,Hardcover,40,2016,2016,3.64,491,0
0553521365,Ebook,32,2016,2016,4.17,491,0
0746042078,Hardcover,127,2000,2001,4.1,491,1
0152562532,Hardcover,44,1997,1997,4.159999999999999,491,0
0345432398,Paperback,128,1999,1999,4.22,491,0
0805067663,Paperback,32,1999,2001,4.23,490,2
1421588641,Paperback,112,1993,2016,4.28,490,23
1984847996,Ebook,40,2019,2019,4.16,489,0
0425288242,Hardcover,40,2018,2018,3.99,489,0
1459813243,Hardcover,32,2017,2017,3.79,489,0
0545035708,Hardcover,32,2006,2008,3.86,489,2
1890008133,Hardcover,44,1944,1959,4.159999999999999,489,15
0733334830,Hardcover,32,2016,2016,3.83,488,0
0802728464,Hardcover,48,2012,2012,4.05,488,0
0763647438,Hardcover,32,2011,2011,3.78,488,0
0954840151,Paperback,828,1980,2006,4.4,488,26
0670035998,Hardcover,40,2003,2003,3.63,488,0
0064432807,Paperback,32,1988,1992,3.45,488,4
0823441733,Hardcover,32,2019,2019,3.92,486,0
162672153X,Hardcover,32,2016,2016,3.73,486,0
125023221X,Hardcover,40,2019,2019,4.13,485,0
1484722825,Hardcover,32,2017,2017,4.19,485,0
1454903848,Hardcover,26,2013,2013,3.96,485,0
1877467626,Hardcover,176,2009,2010,4.08,485,1
0060598514,Hardcover,32,2006,2006,4.02,485,0
0819304042,Hardcover,39,1971,1971,4.35,485,0
0811879429,Board Book,16,2012,2012,4.1,484,0
0310722918,Hardcover,32,2011,2011,4.3,484,0
0763609196,Hardcover,40,2001,2001,4.2,484,0
0152050582,Paperback,44,2003,2004,4.28,483,1
0060283734,Hardcover,40,2006,2006,4.07,482,0
0439627923,Hardcover,56,2004,2004,4.03,482,0
1524737860,Hardcover,32,2018,2018,3.65,481,0
015206091X,Hardcover,40,2007,2007,3.69,481,0
0811803503,Hardcover,40,1990,1993,3.93,481,3
0399235841,Hardcover,32,2002,2002,4.21,481,0
0684194465,Hardcover,176,1992,1992,3.88,481,0
1481464639,Hardcover,40,2017,2017,3.36,480,0
1419708856,Hardcover,40,2013,2014,3.97,480,1
145212454X,Hardcover,32,2014,2014,3.41,480,0
0061229717,Hardcover,40,2008,2008,3.4099999999999997,480,0
0688122671,Paperback,32,1984,1993,3.54,480,9
0374311099,Hardcover,32,1991,1991,4.3,480,0
014030567X,Paperback,144,1969,1972,4.2,480,3
0786816694,Paperback,176,2003,2005,4.1899999999999995,479,2
0802776930,Paperback,252,1946,2004,3.86,479,58
1093239492,Kindle Edition,33,2019,2019,4.98,478,0
0805092196,Hardcover,32,2011,2011,4.1499999999999995,478,0
0823422518,Hardcover,40,1984,2011,4.23,478,27
0064404862,Paperback,288,1985,1993,3.99,478,8
0544868420,Hardcover,32,2017,2017,3.96,477,0
1492632244,Hardcover,32,2016,2016,3.83,477,0
0762453397,Hardcover,40,2015,2015,4.06,477,0
0061920851,Hardcover,40,2012,2012,3.57,477,0
1406323683,Hardcover,32,2010,2010,3.64,477,0
1416979603,Hardcover,32,2010,2010,3.95,477,0
0142401242,Paperback,32,2001,2004,3.81,477,3
0789310627,Hardcover,62,1959,2004,4.33,477,45
9515001412,Hardcover,28,1977,1977,4.109999999999999,477,0
0316113832,Hardcover,80,2006,2008,4.18,477,2
034540386X,Paperback,128,1996,1996,4.21,477,0
2302030508,Hardcover,96,2013,2013,3.19,476,0
0763645710,Hardcover,40,2010,2010,3.81,476,0
0805076352,Paperback,32,2001,2005,3.6,476,4
0340788666,Paperback,458,1993,1993,4.24,476,0
1845395468,Hardcover,32,2011,2011,3.71,475,0
9022945928,Paperback,128,1985,1985,3.4499999999999997,475,0
1597073997,Paperback,124,2011,2013,3.69,475,2
1844280284,Hardcover,56,2002,2004,3.93,475,2
0786816708,Paperback,192,2003,2003,4.21,475,0
1481461915,Hardcover,40,2018,2018,3.87,474,0
0763661821,Hardcover,32,2012,2012,3.89,474,0
1741752663,Hardcover,32,2002,2008,4.18,474,6
0997389907,Kindle Edition,24,2016,2016,4.18,473,0
0062373455,Hardcover,32,2016,2016,3.94,473,0
1741758882,Hardcover,32,2010,2011,3.76,473,1
1580892892,Hardcover,48,2012,2012,4.21,473,0
0152008071,Hardcover,96,2000,2000,3.93,472,0
0439183057,Hardcover,40,2003,2003,4.119999999999999,471,0
0316365629,Hardcover,32,1999,1999,4.109999999999999,471,0
1416986081,Paperback,192,2010,2010,4.22,471,0
1442454725,Hardcover,40,2016,2016,3.54,470,0
006446234X,Paperback,32,1992,2000,4.1499999999999995,470,8
0140501789,Paperback,32,1955,1976,3.94,470,21
1594625913,Paperback,248,1912,2007,3.81,470,95
0316392529,Hardcover,40,2019,2019,4.28,469,0
1626722439,Hardcover,32,2016,2016,4.03,469,0
1444924567,Hardcover,32,2016,2016,3.75,469,0
0843176849,Paperback,32,1978,2001,3.91,469,23
1481480987,Hardcover,304,2015,2016,4.01,469,1
0061170453,Paperback,93,2008,2008,3.81,469,0
1481456156,Hardcover,32,2016,2016,3.87,468,0
1938063090,Hardcover,32,2013,2013,4.08,468,0
006113953X,Hardcover,30,2013,2013,3.67,468,0
0823416038,Hardcover,32,2012,2012,3.55,468,0
1442406739,Hardcover,32,2011,2011,4,468,0
0689835418,Paperback,40,2000,2003,4.14,468,3
0060278412,Hardcover,32,1956,1956,4.21,468,0
0553535773,Hardcover,32,2016,2016,3.71,467,0
0807545120,Hardcover,32,2010,2010,3.98,467,0
0152562575,Hardcover,48,1997,1997,4.21,467,0
0316162264,Hardcover,32,2010,2010,3.79,466,0
0763644749,Hardcover,128,2009,2009,3.93,466,0
0843139234,Paperback,32,1982,1996,4.17,466,14
0819309648,Hardcover,32,1978,1978,4.52,466,0
0763637963,Paperback,40,2007,2007,4.28,466,0
1892657007,Hardcover,48,1969,1998,4.2700000000000005,466,29
1101999748,Hardcover,32,2016,2016,3.6,465,0
1423139836,Hardcover,32,2011,2011,3.99,465,0
1593075731,Paperback,152,2002,2006,3.66,465,4
0670060194,Hardcover,48,2005,2005,3.81,465,0
0545678463,Hardcover,40,2016,2016,3.71,464,0
0803739389,Hardcover,48,2013,2013,3.81,464,0
0312051379,Hardcover,32,1990,1990,4.31,464,0
0979923808,Hardcover,32,2008,2008,3.63,464,0
0803735332,Hardcover,40,2010,2010,3.85,463,0
0140565841,Paperback,32,1978,1999,4.34,462,21
081185664X,Hardcover,32,2007,2007,3.79,461,0
0803740077,Hardcover,128,2014,2014,3.97,461,0
1935179160,Hardcover,40,2012,2012,3.62,461,0
0805090118,Hardcover,32,2011,2011,3.87,460,0
0971216983,Hardcover,176,2007,2007,4.26,460,0
0140562885,Paperback,48,1996,2000,3.86,460,4
0689820089,Paperback,32,1994,1998,4.4,460,4
1554532797,Hardcover,32,2009,2009,3.89,459,0
0064433226,Paperback,32,1961,1993,4.07,459,32
0345445821,Paperback,96,2001,2001,4.29,459,0
0140501800,Paperback,40,1944,1976,3.84,459,32
0060564822,Hardcover,32,2007,2007,4.1499999999999995,458,0
0763694886,Hardcover,48,2018,2018,3.96,457,0
1481460900,Hardcover,32,2017,2017,3.67,457,0
1419717316,Hardcover,30,2014,2015,3.75,457,1
0545153522,Board Book,14,2010,2010,4.06,457,0
031604136X,Hardcover,240,2009,2009,3.87,457,0
0803738471,Hardcover,208,2013,2013,4.33,456,0
0881069884,Paperback,32,2001,2001,3.95,456,0
0064432181,Paperback,32,1979,1990,4.1899999999999995,455,11
160886538X,Hardcover,127,2010,2010,4.49,455,0
0763678937,Hardcover,40,2016,2016,4.02,454,0
1557986428,Hardcover,31,2000,2000,4.430000000000001,453,0
1593170793,Hardcover,36,2004,2004,4.35,453,0
1481468812,Hardcover,32,2017,2017,3.94,451,0
0062189964,Hardcover,40,2014,2015,3.3,451,1
1907152008,Hardcover,32,2010,2010,3.66,451,0
0786837225,Hardcover,28,2007,2007,3.68,451,0
0439078199,Hardcover,40,2000,2000,4.109999999999999,451,0
0394843770,Paperback,32,1980,1980,3.95,451,0
1682631311,Hardcover,32,2019,2019,4.1,450,0
0374313210,Hardcover,40,2013,2013,3.56,450,0
084317725X,Paperback,32,1978,2002,4.1,450,24
1939352495,Paperback,128,2014,2014,3.61,450,0
0689806205,Paperback,32,1986,1995,4.49,450,9
1423152328,Hardcover,40,2012,2012,3.72,449,0
0152060758,Hardcover,44,2007,2007,4.159999999999999,449,0
0316968978,Hardcover,32,1997,2005,4.33,449,8
0473394235,Kindle Edition,24,2015,2015,3.95,448,0
0688511694,Hardcover,40,1965,1965,3.66,448,0
0375846298,Board Book,22,2009,2009,3.9,448,0
0374312516,Hardcover,40,2007,2007,4.17,448,0
0803737882,Hardcover,32,2013,2013,3.83,447,0
1848775709,Hardcover,33,2012,2012,3.99,447,0
0375856862,Hardcover,40,2009,2009,3.64,447,0
0394800907,Hardcover,72,1970,2002,3.97,447,32
0698116763,Hardcover,32,1971,2002,4.6,447,31
039921738X,Hardcover,128,1990,1990,4.58,447,0
0544939077,Hardcover,48,2017,2017,3.79,446,0
0545168465,Hardcover,40,2015,2015,3.89,446,0
0062203185,Hardcover,40,2014,2014,3.47,446,0
0803729367,Hardcover,32,2005,2006,3.94,446,1
140125229X,Paperback,240,2014,2014,4.109999999999999,446,0
081090960X,Hardcover,32,2007,2007,4.1499999999999995,446,0
0374456283,Hardcover,44,2003,2003,4.08,446,0
0345466152,Paperback,96,2007,2007,4.2700000000000005,445,0
068985353X,Paperback,192,1985,2002,3.82,445,17
0062443399,Hardcover,32,2018,2018,3.64,444,0
0375867112,Hardcover,32,2011,2011,3.65,444,0
0374349088,Hardcover,32,2009,2010,3.92,444,1
0805059334,Paperback,32,1995,1998,3.98,444,3
1421522896,Paperback,192,2008,2008,4.49,444,0
1534409173,Hardcover,32,2017,2017,3.72,443,0
0345913469,Paperback,96,2007,2007,4.34,442,0
0689862776,Board Book,28,2001,2006,3.64,440,5
0394817494,Hardcover,32,1964,2007,3.98,440,43
0399212337,Hardcover,32,1985,1985,4.159999999999999,439,0
0060224916,Hardcover,64,1959,1959,3.59,439,0
0544309898,Hardcover,32,2015,2015,3.95,438,0
0803731574,Hardcover,40,2008,2008,4.05,438,0
0706355954,Hardcover,224,1910,1967,4.01,438,57
1626729085,Hardcover,34,2018,2018,3.91,437,0
0062447610,Hardcover,40,2018,2018,4.22,437,0
0763657255,Board Book,24,2011,2011,4.05,437,0
0689851103,Hardcover,32,2004,2004,3.91,437,0
0152060529,Hardcover,80,1992,1992,4.2,437,0
0064402207,Paperback,448,1985,1988,4.33,437,3
0062574205,Hardcover,32,2018,2018,4.13,436,0
1416967338,Hardcover,32,2011,2011,3.86,436,0
1596057831,Paperback,132,1915,2006,4.109999999999999,436,91
0545757916,Hardcover,32,2016,2016,3.74,435,0
1478399473,Paperback,32,2010,2010,3.96,435,0
0618070346,Paperback,32,1997,2000,4,435,3
0816644187,Hardcover,32,1941,2004,3.85,435,63
0399546723,Hardcover,32,2019,2019,4.119999999999999,434,0
1939547377,Hardcover,32,2017,2017,4.1899999999999995,434,0
1408312719,Hardcover,30,2011,2012,4.1499999999999995,434,1
0794521681,Board Book,10,2000,2008,4.09,434,8
0746037791,Board Book,12,2000,2000,4.09,434,0
0399237410,Hardcover,176,2001,2001,4.45,434,0
0545848849,Hardcover,32,2018,2018,3.87,433,0
0544319303,Hardcover,32,2016,2016,3.88,432,0
0763680087,Hardcover,24,2015,2015,4.1,432,0
061813168X,Hardcover,32,2008,2008,3.41,432,0
0439640113,Hardcover,40,2006,2007,3.82,432,1
0689710836,Paperback,32,1982,1997,4.109999999999999,432,15
1419734180,Hardcover,34,2019,2019,4,431,0
1250115825,Hardcover,32,2019,2019,4.25,431,0
0823432106,Hardcover,32,2015,2015,3.87,431,0
0375957065,Hardcover,48,2012,2012,4.1,431,0
0789436507,Board Book,16,1998,1998,4.02,431,0
0316853127,Hardcover,48,1971,1998,4.159999999999999,431,27
0062677381,Hardcover,40,2019,2019,4.14,430,0
141971872X,Hardcover,40,2016,2016,4.13,430,0
0140553266,Paperback,32,1993,1995,4.29,430,2
069000799X,Hardcover,32,1973,1976,3.66,430,3
0761455612,Hardcover,32,2009,2009,4.02,429,0
0763632481,Hardcover,32,2007,2007,3.63,429,0
0803733577,Hardcover,32,2011,2011,4.39,429,0
1596432330,Paperback,92,2008,2008,3.82,429,0
1584854502,Paperback,123,2001,2005,3.83,429,4
030717025X,Hardcover,160,1958,1999,4.48,429,41
0545683572,Hardcover,32,2015,2015,3.68,428,0
0374363633,Hardcover,32,2014,2014,3.57,428,0
0545070759,Hardcover,48,2010,2010,3.69,428,0
0940112094,Hardcover,32,2002,2002,4.619999999999999,428,0
1589251474,Hardcover,28,2013,2013,4.04,427,0
1596438622,Hardcover,36,2013,2013,4.04,427,0
0763647543,Hardcover,32,2012,2012,3.8,427,0
0545162033,Hardcover,48,2010,2010,3.79,427,0
067003620X,Hardcover,32,2004,2004,3.9,427,0
0345464559,Paperback,288,1993,2003,4.41,427,10
0091742501,Hardcover,32,1990,1990,4.34,427,0
1481420666,Hardcover,40,2016,2016,3.96,426,0
1623704251,Hardcover,33,2015,2015,4.25,426,0
0544147995,Hardcover,40,2014,2014,3.93,426,0
0060290161,Hardcover,40,2010,2010,3.77,426,0
0803734042,Hardcover,32,2010,2010,4.07,425,0
0140504427,Paperback,32,1983,1983,4.03,425,0
1250109272,Hardcover,32,2018,2018,3.93,424,0
006235308X,Hardcover,40,2016,2016,3.48,424,0
0763657271,Hardcover,32,2013,2013,3.37,424,0
1402789564,Board Book,18,2012,2012,4.27,424,0
0374483868,Paperback,32,2001,2006,4.09,424,5
0001840266,Hardcover,144,1988,1999,4.53,424,11
1338098969,Hardcover,40,2017,2017,3.82,423,0
0763658812,Hardcover,40,2011,2011,4.08,423,0
0785190996,Hardcover,136,2015,2015,3.91,423,0
0762447214,Hardcover,32,2013,2013,3.79,423,0
0545857015,Hardcover,32,2016,2016,3.74,422,0
1416991557,Hardcover,32,2011,2011,3.83,422,0
0060580240,Hardcover,40,2008,2008,3.97,422,0
0374403848,Paperback,32,1932,1997,4.06,422,65
1417911433,Paperback,384,1911,2005,4.159999999999999,422,94
1101996684,Hardcover,32,2018,2018,4.24,421,0
0399172785,Hardcover,32,2016,2016,3.6,421,0
0399256172,Hardcover,40,2012,2012,3.65,421,0
0152060693,Hardcover,44,2008,2008,4.21,421,0
0689712936,Paperback,32,1974,1989,4.2,421,15
0688012973,Hardcover,48,1981,1982,4.119999999999999,421,1
0544582594,Hardcover,32,2016,2016,3.53,420,0
0545399963,Hardcover,32,2016,2016,3.84,420,0
0679879277,Hardcover,344,1995,1995,4.28,420,0
0066238803,Hardcover,32,2001,2001,3.98,419,0
0152002472,Paperback,44,1998,1999,4.13,419,1
0395280060,Paperback,48,1976,1979,4.24,419,3
1608865428,Hardcover,143,2010,2010,4.619999999999999,419,0
1481479849,Hardcover,40,2017,2017,4.25,418,0
1442480548,Hardcover,40,2014,2014,4.04,418,0
1772780103,Hardcover,32,2017,2017,4.26,418,0
1892213648,Paperback,184,1991,2003,3.75,418,12
0805097597,Hardcover,32,2014,2014,3.55,417,0
015205443X,Paperback,44,2005,2006,4.18,417,1
0689301022,Hardcover,48,1973,1973,4.08,417,0
0152054200,Hardcover,40,2012,2012,3.82,416,0
1564024474,Paperback,32,1990,1995,4.03,416,5
0140547045,Paperback,40,1980,1992,3.86,416,12
0689858086,Hardcover,37,2008,2008,4.14,415,0
0439576768,Hardcover,16,2004,2004,4.15,415,0
0721406475,Paperback,51,1964,1981,4.109999999999999,415,17
0345321065,Paperback,128,1982,1984,4.14,415,2
1442408340,Hardcover,32,2015,2015,3.84,414,0
0152053077,Hardcover,32,2006,2006,4.34,414,0
0060526661,Board Book,34,1998,2003,3.9,414,5
1606996533,Hardcover,226,2013,2013,4.42,414,0
1416986138,Hardcover,176,2011,2011,4.2700000000000005,414,0
1419718908,Hardcover,32,2016,2016,4.02,413,0
1481444077,Hardcover,32,2014,2014,4.13,413,0
0061772038,Hardcover,32,2013,2013,3.86,413,0
0823423506,Hardcover,32,2011,2011,4.13,413,0
067006288X,Hardcover,32,2008,2008,3.72,413,0
0395968879,Paperback,32,1994,1999,3.64,413,5
1554514916,Hardcover,32,2013,2013,4.13,412,0
1581341342,Hardcover,32,2000,2000,4.29,412,0
0399186522,Hardcover,250,2017,2017,4.25,412,0
1423113373,Hardcover,96,2010,2010,3.69,412,0
1595329560,Paperback,192,2000,2006,3.73,412,6
0688173640,Board Book,32,1998,2018,4.09,411,20
0763681806,Hardcover,32,2014,2014,3.82,411,0
0786807679,Hardcover,32,2009,2009,4.2,411,0
1524738808,Hardcover,32,2018,2018,3.78,410,0
0544748026,Hardcover,40,2017,2017,3.76,410,0
1934490253,Paperback,32,2011,2011,4.18,410,0
0140364633,Paperback,76,1974,1995,4.06,410,21
0763686565,Hardcover,32,2016,2016,3.79,408,0
0399163980,Hardcover,40,2016,2016,3.9,408,0
1467721107,Hardcover,32,2015,2015,4.23,408,0
1406324604,Hardcover,40,2011,2011,3.81,408,0
1442403039,Hardcover,40,2009,2009,4.28,408,0
0689858361,Hardcover,32,2005,2005,3.63,408,0
1930900309,Hardcover,64,1967,2004,4.6499999999999995,408,37
0789308843,Hardcover,64,1960,2003,4.29,408,43
0330026550,Paperback,157,1967,1971,4.1499999999999995,408,4
1843652935,Hardcover,32,2014,2014,3.69,407,0
0439698855,Hardcover,32,2013,2013,3.38,407,0
0062189646,Hardcover,40,2013,2013,3.9,407,0
0399256148,Hardcover,32,2012,2012,3.45,407,0
0618233784,Hardcover,336,2008,2008,4.24,407,0
0374416842,Paperback,47,1969,1988,3.87,407,19
1419737260,Hardcover,32,2019,2019,4.35,406,0
031648301X,Hardcover,48,2018,2018,3.75,406,0
0698114140,Paperback,32,1983,1996,3.95,406,13
067987318X,Paperback,32,1991,1995,3.88,406,4
1626726566,Hardcover,48,2018,2018,3.56,405,0
0062336991,Hardcover,40,2015,2015,3.46,405,0
1907152474,Hardcover,32,2010,2010,3.84,405,0
0807573108,Paperback,32,2003,2003,3.82,405,0
0140502750,Paperback,46,1953,1978,3.93,405,25
0763661031,Hardcover,40,2013,2013,3.61,404,0
1585362700,Hardcover,40,1984,2005,4.34,404,21
1589257146,Hardcover,16,1999,2003,3.89,404,4
1891830503,Paperback,178,2004,2005,3.87,404,1
1905417780,Hardcover,32,2008,2008,3.81,403,0
044041363X,Paperback,32,1994,1997,4.04,403,3
0763675970,Hardcover,40,2015,2015,4.04,402,0
0060515732,Hardcover,64,2003,2003,3.97,402,0
0785777806,Hardcover,40,1990,1995,4.07,402,5
0070705208,Hardcover,141,1958,1964,3.84,402,6
0823423700,Hardcover,32,2012,2012,4.03,401,0
0763613827,Hardcover,48,2003,2003,4.2700000000000005,401,0
0843148705,Paperback,32,1978,2002,4.08,401,24
160905248X,Hardcover,40,2012,2012,3.86,400,0
0805090045,Hardcover,40,2010,2010,4.01,400,0
0803733917,Hardcover,32,2014,2014,3.63,399,0
0761451846,Hardcover,64,2004,2004,4.1499999999999995,399,0
0345491726,Paperback,96,2008,2008,4.319999999999999,399,0
0062381229,Hardcover,40,2016,2016,4.18,397,0
0763674176,Hardcover,32,2015,2015,4.33,397,0
1935179128,Hardcover,32,2011,2011,3.84,397,0
0544610555,Hardcover,40,2018,2018,3.84,396,0
0374303827,Hardcover,40,2017,2017,4.04,396,0
0152050671,Hardcover,44,2006,2006,4.2,396,0
1554537789,Hardcover,112,2014,2014,4.07,396,0
0618543597,Hardcover,32,1987,2005,3.66,396,18
1524737380,Hardcover,32,2017,2017,3.95,395,0
0763666874,Hardcover,32,2010,2013,3.57,395,3
8426135331,Hardcover,32,1987,2006,3.65,395,19
1584850809,Paperback,40,2000,2000,4.05,395,0
1584740116,Hardcover,88,1819,1999,4.25,395,180
0590003429,Paperback,32,1969,1969,4.05,395,0
0547171846,Hardcover,32,2010,2010,4.17,394,0
0062456709,Hardcover,40,2018,2018,4.1899999999999995,393,0
1452148570,Hardcover,40,2018,2018,3.88,393,0
0544319605,Hardcover,32,2016,2016,3.97,393,0
0823433889,Hardcover,32,2015,2015,3.82,393,0
1559707984,Hardcover,32,2006,2006,3.95,393,0
006440398X,Paperback,320,1991,1994,3.92,393,3
0374316996,Hardcover,40,2014,2014,4.13,392,0
0590026119,Paperback,32,1998,1998,4.09,392,0
1741144884,Paperback,32,1990,2006,4.22,392,16
1845074564,Hardcover,48,1936,2006,3.85,391,70
039923876X,Hardcover,40,2005,2005,3.74,391,0
1416971475,Hardcover,24,2009,2009,3.84,390,0
0803738498,Hardcover,208,2014,2014,4.29,390,0
0152622101,Hardcover,32,1991,1991,4.159999999999999,390,0
0062845225,Hardcover,40,2019,2019,3.73,389,0
0698114272,Paperback,32,1992,1997,3.98,389,5
0823441563,Hardcover,40,2019,2019,3.88,388,0
089236372X,Hardcover,44,1999,1999,4.29,388,0
1771473517,Hardcover,32,2019,2019,4.15,387,0
1481448315,Hardcover,40,2016,2016,3.88,387,0
0545153549,Board Book,14,2010,2010,3.87,387,0
0805092323,Hardcover,32,2018,2018,4.16,386,0
1416906649,Hardcover,32,2011,2011,3.69,386,0
0843105852,Paperback,32,1974,2003,4.01,386,29
0684189984,Hardcover,32,1950,1988,3.49,386,38
1947165682,Kindle Edition,36,2018,2018,4.26,386,0
0061688681,Hardcover,304,2009,2009,3.55,386,0
0375858636,Hardcover,40,2010,2010,3.94,385,0
1481498223,Hardcover,32,2016,2017,3.91,384,1
125012770X,Hardcover,32,2017,2017,3.94,384,0
0805099875,Hardcover,40,2015,2015,3.77,384,0
1416957960,Hardcover,32,2007,2008,3.83,384,1
1606994417,Hardcover,286,2011,2011,4.1499999999999995,384,0
184507534X,Hardcover,32,2009,2009,4.38,384,0
0689870418,Hardcover,80,2005,2005,4.02,384,0
0531070824,Paperback,32,1992,1996,4.21,384,4
1097468259,Kindle Edition,25,2019,2019,4.98,382,0
0553511270,Hardcover,24,2016,2016,3.62,382,0
0823436470,Hardcover,32,2016,2016,3.95,382,0
0385754175,Hardcover,40,2016,2016,3.77,382,0
0140502882,Paperback,48,1959,1989,4.1,382,30
162979208X,Hardcover,40,2016,2016,4.1499999999999995,381,0
0545243386,Hardcover,32,2011,2011,3.86,381,0
0670062588,Hardcover,32,2009,2009,3.68,381,0
177147131X,Hardcover,40,2016,2016,3.53,380,0
0763673773,Hardcover,40,2014,2014,3.29,380,0
0545354773,Hardcover,34,2014,2014,4.13,380,0
0525469680,Hardcover,40,2003,2003,3.75,380,0
0140555374,Paperback,40,1991,2002,4.42,380,11
0679887180,Paperback,32,1998,1998,4.109999999999999,380,0
0618737405,Hardcover,72,2010,2010,4.23,380,0
0345464621,Paperback,96,2005,2005,4.1899999999999995,380,0
148143019X,Hardcover,32,2015,2015,3.94,379,0
1927271037,Hardcover,32,2007,2015,3.88,379,8
0803702906,Hardcover,32,1986,1986,3.67,379,0
1561457299,Hardcover,36,2014,2014,3.77,379,0
1536201669,Hardcover,34,2019,2019,4.24,378,0
080509251X,Hardcover,40,2016,2016,3.76,378,0
145213264X,Hardcover,56,2013,2016,3.95,378,3
0062014196,Hardcover,40,2012,2012,3.21,378,0
0448043041,Hardcover,80,1976,1989,4.52,378,13
0553509713,Hardcover,32,2017,2017,3.8,377,0
1421526565,Paperback,200,2009,2009,4.14,377,0
0375825509,Hardcover,40,1973,2003,4.3,377,30
1338349899,Hardcover,26,2019,2019,3.93,376,0
1524713317,Hardcover,40,2018,2018,3.96,376,0
1101938846,Hardcover,32,2018,2018,3.97,376,0
1619638878,Hardcover,64,2017,2017,3.83,376,0
0439753821,Hardcover,40,2005,2005,3.69,376,0
1582460787,Paperback,40,1999,2002,4.07,376,3
0590264702,Paperback,32,1980,1995,3.59,376,15
0062470523,Hardcover,32,2016,2016,3.45,375,0
1101996218,Hardcover,32,2016,2016,3.63,375,0
1481421050,Hardcover,48,2016,2016,2.9299999999999997,375,0
1580894046,Paperback,28,2011,2012,3.97,375,1
0448455684,Hardcover,144,2010,2010,3.71,375,0
0316114936,Hardcover,48,2006,2006,4.37,375,0
0399186557,Hardcover,240,2018,2018,4.41,375,0
0060598549,Hardcover,32,2007,2007,4.07,374,0
0810994836,Hardcover,32,2008,2008,3.94,373,0
0374348103,Hardcover,32,2006,2006,4.04,373,0
1452162557,Hardcover,64,2018,2018,3.97,372,0
1402266480,Hardcover,32,2012,2012,3.95,372,0
0843176326,Paperback,32,1978,2001,4.06,372,23
0374311501,Hardcover,32,1995,1997,4.24,372,2
0345522443,Paperback,96,2010,2010,4.31,372,0
1935179004,Hardcover,32,2009,2009,3.34,372,0
2205049674,Hardcover,50,1994,2001,3.95,372,7
155037396X,Paperback,33,1995,1995,3.99,371,0
0689805381,Paperback,32,1971,1996,3.74,371,25
159017173X,Hardcover,32,1947,2005,4.1899999999999995,370,58
1570915229,Hardcover,32,2005,2005,4.22,370,0
0395292026,Paperback,48,1975,1980,3.8,370,5
156145396X,Hardcover,32,2007,2007,3.98,369,0
1596436212,Paperback,192,2013,2013,4.119999999999999,369,0
086315106X,Hardcover,24,1906,1990,4.28,369,84
1481494724,Hardcover,40,2019,2019,4.13,368,0
0399539050,Hardcover,88,2017,2017,4.02,368,0
163405962X,Hardcover,64,2016,2016,4.470000000000001,368,0
0874836026,Paperback,32,1998,2005,4.24,368,7
0843105941,Paperback,32,1978,2003,4.109999999999999,368,25
1408338378,Hardcover,32,2017,2017,3.96,367,0
0763672912,Hardcover,32,2017,2017,3.88,367,0
0375971548,Hardcover,40,2015,2015,3.97,367,0
0803725876,Hardcover,32,2004,2004,4.14,367,0
015216412X,Paperback,36,1998,2001,3.94,367,3
0525553290,Hardcover,32,2019,2019,4.02,366,0
0375973257,Hardcover,40,2013,2015,3.85,366,2
1442456841,Hardcover,40,2012,2012,3.6,366,0
1492688924,Hardcover,96,2019,2019,4.3,366,0
0312376472,Hardcover,32,2013,2013,3.82,366,0
0345464664,Paperback,96,2006,2006,4.23,366,0
0761452230,Hardcover,32,2006,2006,4.28,364,0
0545234972,Hardcover,40,2012,2012,4.24,363,0
0062008285,Hardcover,32,2011,2011,3.66,363,0
0152024948,Hardcover,32,2010,2010,3.62,363,0
1405090286,Paperback,32,2006,2007,3.89,363,1
0679887369,Hardcover,176,1986,2003,4.159999999999999,363,17
1626721432,Paperback,128,2016,2016,4.25,363,0
1416985859,Hardcover,32,2009,2009,3.97,363,0
0399186417,Kindle Edition,32,2017,2017,3.97,362,0
0230769888,Hardcover,32,2013,2013,4.09,362,0
0689863748,Paperback,40,2001,2004,4.1899999999999995,362,3
0803733356,Hardcover,32,2009,2009,3.87,361,0
1452139113,Hardcover,34,2018,2018,4.159999999999999,360,0
0316065641,Hardcover,32,1998,2002,4.28,360,4
0545883792,Hardcover,40,2017,2017,3.79,359,0
0385392834,Hardcover,32,2015,2015,3.62,359,0
0060758988,Hardcover,40,2015,2015,3.96,359,0
076360674X,Board Book,22,1994,2011,4.01,359,17
0517800578,Board Book,32,1988,1999,3.96,359,11
0399171606,Hardcover,32,2015,2015,3.77,358,0
0618117563,Hardcover,31,2002,2004,3.58,358,2
0689815034,Hardcover,40,1998,1998,3.89,358,0
0698114299,Paperback,32,1993,1997,4.21,358,4
0763678538,Hardcover,288,2015,2016,4.01,358,1
1909263370,Hardcover,30,2016,2016,4.26,356,0
0763661627,Hardcover,36,2013,2014,3.95,356,1
0763666165,Hardcover,32,2013,2013,3.7,356,0
0064438147,Paperback,32,2003,2009,3.56,356,6
1580897126,Hardcover,32,2017,2017,4.22,355,0
0545864178,Hardcover,32,2016,2016,3.38,355,0
1933605898,Hardcover,26,2008,2009,3.6,354,1
0763625485,Hardcover,40,2007,2007,3.99,354,0
0316989126,Hardcover,32,2003,2005,3.96,354,2
0345491777,Paperback,96,2008,2008,4.14,354,0
0375810757,Hardcover,56,1949,2001,3.97,354,52
0152002480,Hardcover,32,1996,1996,4.2700000000000005,354,0
0061547514,Hardcover,40,2009,2009,3.91,353,0
0440422108,Paperback,48,1964,1981,4.52,353,17
1848575866,Hardcover,32,2017,2017,4.1499999999999995,352,0
1842555456,Paperback,208,1970,2009,3.61,352,39
1338177362,Hardcover,32,2018,2018,4.1,351,0
0823436802,Hardcover,32,2017,2017,3.59,351,0
0763644773,Hardcover,40,2011,2011,3.85,351,0
068986972X,Hardcover,32,2007,2007,4.07,351,0
0064442373,Paperback,32,1995,1997,3.79,351,2
0689817061,Paperback,32,1994,1997,4.159999999999999,351,3
0531085570,Hardcover,48,1991,1991,4.24,351,0
033042534X,Paperback,198,2009,2009,3.76,351,0
067001091X,Hardcover,128,2009,2009,3.96,351,0
0316435163,Ebook,40,2019,2019,4.31,350,0
1943147426,Hardcover,40,2018,2018,4.359999999999999,350,0
1481468243,Hardcover,48,2017,2017,4.17,350,0
0867130970,Hardcover,100,2007,2007,4.42,350,0
0375856129,Hardcover,32,2009,2009,3.58,350,0
0486280233,Paperback,96,1918,1994,4.1499999999999995,350,76
0545418461,Hardcover,32,2015,2015,3.44,349,0
054427220X,Hardcover,32,2015,2015,3.89,349,0
080757824X,Hardcover,32,2009,2009,4.01,349,0
0670062308,Hardcover,48,1969,2007,3.84,349,38
0689868936,Hardcover,32,2006,2006,3.93,349,0
0064450783,Paperback,32,1981,1988,3.74,349,7
184780294X,Hardcover,168,2013,2013,4.05,349,0
0345491769,Paperback,96,2009,2009,4.21,349,0
0451135814,Paperback,175,1984,1985,4.17,349,1
0746041837,Board Book,12,2001,2001,4.01,348,0
0395683947,Hardcover,32,1994,1994,3.79,348,0
0399254277,Hardcover,224,2012,2012,4.31,348,0
0399557016,Hardcover,32,2017,2017,3.76,347,0
0807541869,Hardcover,24,2012,2012,3.99,347,0
080279758X,Hardcover,32,2007,2008,3.93,347,1
1596432926,Paperback,124,2009,2011,3.77,347,2
1587170558,Paperback,181,1913,2001,3.77,347,88
0993367062,Paperback,36,2018,2018,4.04,346,0
0062675400,Hardcover,32,2018,2018,3.6,346,0
0525428534,Hardcover,40,2017,2017,4.35,346,0
0374300070,Hardcover,32,2015,2015,4.07,346,0
080272082X,Hardcover,40,2010,2010,3.95,346,0
054704982X,Hardcover,32,2009,2009,4.05,346,0
0689856768,Paperback,32,1999,2003,3.97,346,4
189478653X,Hardcover,92,2014,2014,4.119999999999999,346,0
0863154573,Hardcover,240,1918,2004,4.42,346,86
1786030209,Hardcover,32,2017,2017,4.1,345,0
1845075331,Hardcover,30,2009,2009,3.95,345,0
1416967958,Hardcover,32,2009,2009,3.64,345,0
1932416390,Hardcover,64,2006,2006,4.3,345,0
1414319487,Hardcover,304,2009,2009,4.06,345,0
0879518820,Hardcover,288,1941,1998,4.1899999999999995,345,57
0590407325,Paperback,256,1947,1987,4.14,345,40
148144977X,Hardcover,40,2017,2017,3.75,344,0
1623700000,Hardcover,32,2013,2013,4.17,344,0
0823420272,Hardcover,32,2006,2006,3.83,344,0
073522871X,Hardcover,40,2018,2018,4.470000000000001,343,0
0723205736,Hardcover,27,1905,1905,3.73,343,0
0590013394,Paperback,154,1951,1951,4.430000000000001,343,0
0763699152,Hardcover,24,2018,2018,3.54,342,0
1250054575,Hardcover,40,2015,2015,3.67,342,0
1250056470,Hardcover,38,2015,2015,3.79,342,0
0786838345,Hardcover,28,1997,2006,4.08,342,9
0399227016,Hardcover,1,1994,1994,3.74,342,0
0064434923,Paperback,32,1995,1998,4.08,342,3
091467627X,Paperback,40,1979,1979,4.58,342,0
1250108144,Hardcover,40,2017,2017,3.83,341,0
0140565728,Paperback,32,1999,2000,4.2,341,1
1596436409,Hardcover,64,2014,2014,3.9,341,0
190926301X,Hardcover,48,2010,2013,3.6,341,3
2756002313,Hardcover,47,2006,2006,4.01,341,0
0689835426,Paperback,40,2001,2005,4.1,341,4
0545316103,Hardcover,32,2012,2012,3.53,340,0
0439769272,Hardcover,40,2005,2005,4.24,340,0
0399168982,Hardcover,32,2015,2015,3.61,339,0
1580892515,Hardcover,40,2012,2012,3.92,339,0
0375944427,Hardcover,40,2011,2011,4.04,339,0
0689859082,Hardcover,32,2002,2003,4.109999999999999,339,1
0064435776,Paperback,32,1996,2000,3.81,339,4
0152296786,Hardcover,32,1958,1983,4.25,339,25
0763679704,Hardcover,32,2016,2016,3.7,338,0
0763681008,Hardcover,32,2016,2016,3.94,338,0
1405089458,Hardcover,23,2008,2008,3.85,338,0
0517558181,Paperback,48,1981,1982,4.5,338,1
0763690104,Hardcover,32,2016,2016,3.93,338,0
0316418862,Hardcover,28,1990,1990,4.21,338,0
0545833213,Hardcover,32,2016,2016,3.77,337,0
142631373X,Paperback,176,2013,2013,4.1899999999999995,337,0
1416986324,Hardcover,24,2009,2009,3.63,337,0
0142500623,Paperback,32,1999,2003,4.33,337,4
1626721459,Paperback,128,2016,2016,4.25,337,0
1760122912,Hardcover,24,2016,2016,3.76,336,0
0786851422,Hardcover,40,2016,2016,4.18,336,0
0060561688,Hardcover,32,2005,2005,3.66,336,0
0434803774,Hardcover,64,1945,1998,3.95,336,53
0926637142,Hardcover,32,1995,1995,4.29,336,0
0152050701,Hardcover,44,2009,2009,4.05,335,0
0763609080,Paperback,24,1999,1999,3.83,335,0
0887763804,Paperback,24,1995,1998,4.2,335,3
0525479473,Hardcover,32,2008,2008,4.25,335,0
0375832629,Hardcover,24,1952,2005,4.35,335,53
076368841X,Hardcover,40,2019,2019,4.01,334,0
1973349205,Kindle Edition,32,2017,2017,4.25,334,0
1442481102,Hardcover,32,2010,2013,3.85,334,3
0345524195,Paperback,96,2011,2011,4.38,334,0
0152163964,Paperback,32,1997,2002,4.21,334,5
0399230165,Hardcover,34,1969,1999,4.31,334,30
1328967190,Hardcover,32,2019,2019,3.74,333,0
0062791109,Hardcover,40,2018,2018,3.84,333,0
1605372277,Hardcover,26,2015,2016,4.08,333,1
0803739230,Hardcover,32,2016,2016,3.66,333,0
1481445146,Hardcover,32,2014,2015,3.63,333,1
0316033901,Hardcover,32,2009,2009,3.7,333,0
0152047662,Hardcover,40,2005,2005,3.89,333,0
1452146594,Hardcover,160,2014,2016,3.75,333,2
0385384157,Hardcover,40,2015,2015,3.84,333,0
0345491815,Paperback,96,2010,2010,4.29,333,0
184643761X,Hardcover,32,2016,2016,3.7,332,0
0763642754,Hardcover,56,2009,2009,3.67,332,0
084314873X,Paperback,32,1982,2002,4.26,332,20
0689715102,Paperback,40,1976,1991,4.28,332,15
1421518058,Paperback,208,1998,2008,3.89,332,10
1590171594,Hardcover,180,1969,2005,4.25,332,36
054591728X,Hardcover,32,2018,2018,3.65,331,0
1250128056,Hardcover,32,2018,2018,3.71,331,0
1419718916,Hardcover,24,2016,2016,3.89,331,0
0763668265,Hardcover,32,2012,2014,3.71,331,2
1865044059,Hardcover,24,2011,2011,4.07,331,0
0531068579,Hardcover,16,1994,2001,4.35,331,7
0823409074,Paperback,40,1812,1991,4.13,331,179
0340788674,Paperback,512,1995,2000,4.08,331,5
0064401243,Paperback,194,1967,1981,4.01,331,14
158536231X,Kindle Edition,32,2004,2013,4.3,330,9
0763641642,Hardcover,40,2011,2011,4.109999999999999,330,0
0843148896,Paperback,32,1974,2002,4.13,330,28
1582402531,Hardcover,112,1997,2002,3.78,330,5
193470654X,Hardcover,36,2009,2009,3.97,329,0
037582264X,Board Book,32,1940,2002,3.82,329,62
0307202038,Hardcover,48,1953,2001,3.88,329,48
1846860849,Hardcover,32,2007,2007,4.1499999999999995,329,0
1684460751,Hardcover,32,2020,2020,4.44,328,0
0525515747,Hardcover,52,2019,2019,4.03,328,0
1416938087,Hardcover,32,2010,2010,3.91,328,0
0984080686,Hardcover,32,2010,2010,4.319999999999999,328,0
0152024417,Hardcover,40,2002,2002,4.05,328,0
1596432624,Paperback,176,2010,2010,3.84,328,0
2205058894,Hardcover,64,2007,2007,4.01,328,0
1930900325,Hardcover,61,1965,2005,4.37,328,40
157505342X,Hardcover,40,2003,2003,4.31,328,0
0440411823,Paperback,176,2001,2003,3.91,328,2
1499802854,Hardcover,32,2016,2016,3.74,327,0
054598663X,Board Book,32,2010,2010,4.21,327,0
0439727669,Hardcover,32,2006,2007,3.93,327,1
0805079432,Hardcover,32,2006,2006,3.61,327,0
0140501878,Paperback,34,1975,1977,4.2,327,2
1419714864,Hardcover,36,2015,2015,3.28,327,0
0689716362,Paperback,32,1963,1992,4.48,327,29
0374303010,Hardcover,48,2017,2017,4.159999999999999,326,0
1419721259,Hardcover,24,2016,2016,4.03,326,0
1589251636,Hardcover,32,2014,2014,3.59,326,0
1596436751,Hardcover,32,2013,2013,3.72,326,0
0394881788,Paperback,32,1986,2006,4.06,326,20
0618234853,Hardcover,32,2005,2005,3.76,326,0
0843138254,Paperback,32,1984,1998,4.17,326,14
0688075363,Hardcover,32,1988,1988,3.83,326,0
1416937706,Hardcover,32,2009,2009,3.92,326,0
1250206596,Hardcover,32,2019,2019,3.85,325,0
1629794538,Hardcover,32,2018,2018,4.22,325,0
0805097295,Hardcover,40,2014,2014,3.93,325,0
0439783151,Hardcover,32,2008,2008,3.74,325,0
1599900211,Hardcover,32,2005,2007,3.9,325,2
188694735X,Hardcover,43,1998,1998,4.25,325,0
0763679097,Hardcover,40,2017,2017,3.57,324,0
0723237565,Hardcover,48,1984,1991,4.31,324,7
0763655961,Hardcover,146,2013,2013,3.93,324,0
068815283X,Paperback,32,1995,1997,3.8,324,2
0899194605,Hardcover,48,1987,1987,4.06,324,0
0670215406,Hardcover,236,1948,1948,4.46,324,0
1481488031,Hardcover,40,2018,2018,3.74,323,0
1499807201,Hardcover,40,2018,2018,4.37,322,0
1471124711,Ebook,32,2017,2017,3.63,322,0
0670065978,Hardcover,32,2012,2012,4.18,322,0
0823421635,Hardcover,32,2011,2011,3.76,322,0
0152162909,Hardcover,40,2008,2008,4.18,322,0
0688131026,Paperback,32,1976,1994,3.94,322,18
1596431792,Hardcover,40,2007,2007,3.74,322,0
0152015469,Paperback,32,1871,1997,4.17,322,126
1632172224,Hardcover,48,2019,2019,4.38,321,0
0670016497,Hardcover,44,2016,2016,4.01,321,0
054428612X,Hardcover,32,2015,2015,3.56,321,0
0545464773,Hardcover,32,2013,2013,3.32,321,0
0062072994,Hardcover,32,2012,2012,3.56,321,0
1416961232,Hardcover,40,2012,2012,3.75,321,0
0061990299,Hardcover,40,2010,2010,4.24,321,0
0060851546,Hardcover,24,2007,2007,3.58,321,0
0823420663,Hardcover,26,2007,2007,3.76,321,0
0689810539,Paperback,32,1978,1997,4.56,321,19
1467751235,Hardcover,40,2017,2017,4.22,320,0
0803716427,Hardcover,40,2012,2012,3.92,320,0
1596434929,Hardcover,32,2010,2010,3.65,320,0
0805081925,Hardcover,48,2009,2009,3.83,320,0
0375838430,Hardcover,32,2007,2007,4.09,320,0
0843176628,Paperback,32,1984,2001,4.24,320,17
0762453389,Hardcover,32,2017,2017,3.84,319,0
1471162249,Paperback,32,2017,2017,4.05,319,0
0440412854,Paperback,40,1983,1996,4.37,319,13
0689863497,Paperback,32,1999,2003,4.34,319,4
0552569380,Paperback,32,2016,2016,3.54,318,0
0399166920,Hardcover,42,2016,2016,4.28,318,0
0763660132,Hardcover,32,2015,2015,3.68,318,0
0060872535,Hardcover,32,2006,2006,3.65,318,0
0448421917,Paperback,32,2000,2000,4.03,318,0
0887764363,Paperback,24,1993,1998,4.1899999999999995,318,5
0545470129,Hardcover,32,2017,2017,4.2,318,0
0763629928,Paperback,128,1997,2006,3.77,318,9
076367480X,Hardcover,32,2015,2015,3.64,317,0
1423625757,Board Book,20,2012,2012,4.05,317,0
0208021914,Hardcover,82,1947,1988,4.21,317,41
0786805684,Hardcover,32,2002,2002,3.96,316,0
161655889X,Hardcover,96,2015,2015,4.1899999999999995,316,0
1596439173,Paperback,112,2014,2014,3.6,316,0
0060554479,Paperback,40,2005,2008,4.1,316,3
156247765X,Hardcover,39,1999,1999,3.88,316,0
0399163999,Hardcover,34,2018,2018,3.74,315,0
0802720668,Hardcover,40,2010,2010,4.13,315,0
0152062300,Hardcover,40,2008,2008,3.58,315,0
0760778698,Hardcover,32,1963,2006,3.93,315,43
0689805527,Hardcover,40,2000,2000,3.88,315,0
0064432114,Paperback,32,1987,1989,4.41,315,2
0763687219,Hardcover,32,2016,2016,3.78,314,0
0316068721,Hardcover,40,2010,2010,3.94,314,0
0744544599,Hardcover,30,1996,1996,4.05,314,0
0984586709,Hardcover,48,1980,2013,4.54,314,33
1561632139,Hardcover,32,1891,1998,3.69,314,107
1627796436,Hardcover,48,2018,2018,4.1899999999999995,313,0
015206415X,Hardcover,40,2012,2012,4.04,313,0
0803728093,Hardcover,32,2005,2005,3.98,313,0
0152047611,Paperback,40,1999,2003,3.99,313,4
0142500356,Paperback,32,1966,2003,3.73,313,37
0544715578,Hardcover,48,2017,2017,4.01,312,0
0007540329,Paperback,32,2015,2015,3.76,312,0
015205071X,Hardcover,48,2011,2011,4.01,312,0
1416986944,Hardcover,32,2011,2011,3.81,312,0
0544611632,Hardcover,40,2016,2016,4.17,311,0
0763633038,Board Book,26,2005,2007,3.73,311,2
0553497219,Hardcover,32,2015,2015,3.3499999999999996,310,0
0060780037,Hardcover,40,2014,2014,3.9,310,0
0316184055,Hardcover,44,2013,2013,3.92,310,0
1631403222,Paperback,88,2015,2015,3.95,310,0
0786948094,Hardcover,80,2007,2007,4.21,310,0
0439877571,Hardcover,48,2009,2009,4.26,309,0
0375801464,Hardcover,24,1959,1999,4.109999999999999,309,40
0735228841,Hardcover,32,2018,2018,3.67,308,0
031651313X,Hardcover,32,2018,2018,4,308,0
0374306141,Hardcover,40,2018,2018,4.18,308,0
0062393472,Hardcover,32,2017,2017,3.73,308,0
0062328166,Hardcover,32,2015,2015,3.7,308,0
006187485X,Hardcover,28,2011,2011,3.62,308,0
0374411778,Paperback,32,1991,2002,3.85,308,11
156402671X,Paperback,32,1992,1996,3.95,308,4
0805008012,Paperback,32,1980,1988,4.08,308,8
0440228549,Paperback,128,1999,2009,3.46,308,10
0553112449,Paperback,40,1955,2004,4.119999999999999,308,49
1454932201,Hardcover,48,2019,2019,4.359999999999999,307,0
1481469991,Hardcover,40,2018,2018,3.86,307,0
0399556761,Hardcover,40,2018,2018,3.74,307,0
153441097X,Hardcover,48,2018,2018,4.25,307,0
0761457976,Hardcover,32,2010,2010,3.55,307,0
0746037821,Board Book,12,1999,1999,4.11,307,0
0688154468,Hardcover,32,1998,1998,3.4499999999999997,307,0
0843138297,Paperback,32,1978,1995,4.05,307,17
0385075731,Hardcover,45,1944,1955,3.82,307,11
1250016894,Hardcover,40,2014,2014,3.49,306,0
0843148888,Paperback,32,1986,2002,4.21,306,16
0786807377,Hardcover,32,2001,2001,3.89,306,0
0439323711,Hardcover,40,2003,2003,4.1499999999999995,306,0
0803710968,Hardcover,32,1992,1992,4.1899999999999995,306,0
0805095195,Hardcover,36,2013,2013,3.7,305,0
0152067159,Hardcover,44,2010,2010,4.1499999999999995,305,0
0152165428,Paperback,32,1999,2002,4.04,305,3
0374349061,Hardcover,32,1996,2000,3.71,305,4
0152010807,Hardcover,40,1867,2000,3.4499999999999997,305,133
076369844X,Hardcover,40,2018,2018,3.63,304,0
1454923229,Hardcover,32,2018,2018,3.85,304,0
1481458566,Hardcover,40,2017,2017,3.8,304,0
080272311X,Hardcover,40,2013,2013,4.05,304,0
0439823234,Hardcover,32,2006,2006,3.82,304,0
0786819952,Hardcover,32,2002,2003,4.119999999999999,304,1
0394858182,Paperback,32,1983,1983,4.2,304,0
0064431886,Paperback,32,1961,1988,3.85,304,27
0803736886,Hardcover,40,2014,2014,3.77,303,0
0374374872,Hardcover,36,2013,2013,3.87,303,0
0060090820,Paperback,32,2003,2007,3.97,303,4
0316779822,Hardcover,32,2004,2004,4.159999999999999,303,0
0316608041,Board Book,22,1989,2001,4.109999999999999,303,12
0679870415,Paperback,80,1993,1995,3.7,303,2
0140505288,Paperback,32,1986,1989,4.44,303,3
0761453938,Hardcover,32,2008,2008,3.88,303,0
0394805798,Hardcover,48,1936,2002,3.96,303,66
0545914329,Hardcover,40,2019,2019,3.76,302,0
1481458949,Hardcover,40,2017,2017,3.63,302,0
1442458437,Hardcover,40,2013,2013,3.72,302,0
0763618519,Hardcover,32,2003,2003,4.1499999999999995,302,0
1984830376,Hardcover,26,2019,2019,3.84,301,0
1627790810,Hardcover,32,2016,2016,3.86,301,0
1909263079,Hardcover,64,2013,2013,4.54,301,0
0061349208,Hardcover,32,2010,2010,4.24,301,0
1416937781,Hardcover,40,2009,2009,3.7,301,0
0823421414,Hardcover,24,2008,2008,3.82,301,0
1580890717,Paperback,32,2001,2001,3.77,301,0
0399213619,Hardcover,32,1986,1986,4.33,301,0
0763699497,Paperback,40,2017,2017,3.6,300,0
0802722733,Hardcover,48,2011,2011,4.21,300,0
1590172124,Hardcover,324,1883,2006,3.62,300,123
0374303525,Hardcover,32,2016,2016,3.97,299,0
1627793046,Hardcover,32,2016,2016,3.93,299,0
0763607886,Paperback,40,1997,2000,4.03,299,3
0448030845,Board Book,16,1963,1963,4.44,299,0
1419703781,Hardcover,40,2012,2012,3.32,298,0
0062080393,Hardcover,128,2008,2011,3.5,298,3
0439557178,Paperback,64,2004,2005,3.9,298,1
1250127734,Hardcover,32,2019,2019,4.2,297,0
1554983851,Hardcover,24,2007,2014,3.57,297,7
0689858191,Hardcover,48,2003,2003,4.24,297,0
0688147801,Hardcover,32,2000,2000,3.82,297,0
0590033751,Hardcover,40,1999,1999,3.76,297,0
0746077696,Paperback,24,2007,2011,4.29,297,4
0544105184,Hardcover,32,2016,2016,3.51,296,0
0316272639,Hardcover,32,2016,2016,3.94,296,0
1626723338,Hardcover,32,2016,2016,3.46,296,0
1101917938,Hardcover,48,2016,2016,4.119999999999999,296,0
0062019635,Hardcover,32,2011,2011,3.6,296,0
0803732562,Hardcover,32,2009,2009,3.17,296,0
0805080899,Hardcover,32,2009,2009,4.11,296,0
054500005X,Hardcover,40,2007,2007,3.47,296,0
1561453749,Hardcover,32,2006,2006,4.2,296,0
1608869075,Paperback,208,2016,2016,4.2,296,0
275600572X,Hardcover,46,2007,2007,4.01,296,0
0763669121,Hardcover,40,2015,2015,3.82,295,0
0805094857,Hardcover,32,2013,2014,3.61,295,1
076134599X,Hardcover,48,2010,2010,4,295,0
146771805X,Hardcover,32,2014,2014,4.26,294,0
1592701108,Hardcover,208,2008,2011,4.1499999999999995,294,3
0064434729,Paperback,32,1962,1997,4.03,294,35
0843138300,Paperback,32,1988,1995,4.119999999999999,294,7
1947534963,Hardcover,32,2018,2018,4.46,293,0
039924526X,Hardcover,32,2007,2007,4.41,293,0
0374399689,Hardcover,40,2004,2004,3.74,293,0
0763618578,Paperback,32,2000,2002,3.68,293,2
080506771X,Hardcover,32,2003,2003,3.81,293,0
1101937912,Hardcover,40,2016,2016,4.1,292,0
0763659525,Hardcover,32,2011,2012,3.89,292,1
0805089071,Hardcover,44,2011,2011,4.04,292,0
0156400103,Paperback,32,1977,1977,4.13,292,0
1906250081,Hardcover,32,2008,2008,3.75,291,0
0140368507,Paperback,128,1968,1994,4.109999999999999,291,26
0763670596,Hardcover,32,2014,2014,3.67,290,0
0395520177,Paperback,80,1962,1989,4.37,290,27
1417920319,Paperback,160,1901,2004,3.82,290,103
006287800X,Hardcover,40,2020,2020,4.29,289,0
0763688436,Hardcover,32,2018,2018,3.8,289,0
0763673080,Hardcover,40,2017,2017,4.06,289,0
0823433919,Hardcover,32,2015,2015,4.34,289,0
0802797075,Hardcover,32,2006,2007,4.04,289,1
0152024255,Paperback,36,1998,2001,3.59,289,3
0064435954,Paperback,32,1997,1999,3.64,289,2
1449470947,Paperback,144,2016,2016,3.84,289,0
2205049682,Hardcover,48,1995,2000,4.03,289,5
1408349205,Hardcover,32,2018,2018,4.22,288,0
1481418513,Hardcover,32,2016,2016,3.43,288,0
0061170577,Hardcover,32,2011,2014,3.51,288,3
0805078584,Hardcover,40,2011,2011,4.03,288,0
1554535689,Hardcover,32,2011,2011,3.65,288,0
1404857273,Board Book,20,2010,2010,3.54,288,0
0399240055,Hardcover,32,2009,2009,3.67,288,0
0803741219,Hardcover,40,2019,2019,4,287,0
0618445579,Hardcover,32,2005,2005,4.28,287,0
1854306960,Paperback,32,1996,2000,4.14,287,4
0694010340,Board Book,24,1998,1998,3.8,287,0
0803739869,Hardcover,208,2016,2016,4.39,287,0
1401249469,Paperback,128,2014,2015,3.92,287,1
275601110X,Hardcover,47,2008,2008,4.03,287,0
0020432801,Paperback,32,1980,1984,4.05,287,4
1534426876,Hardcover,40,2019,2019,3.21,286,0
1524771872,Hardcover,40,2019,2019,4.23,286,0
1561458848,Hardcover,32,2015,2015,4.02,286,0
1554983223,Hardcover,32,2014,2014,3.84,286,0
0062218085,Hardcover,32,2013,2013,3.94,286,0
0763661511,Hardcover,48,2013,2013,3.97,286,0
0399252886,Hardcover,32,2012,2012,3.74,286,0
0545206340,Hardcover,48,2010,2010,4.31,286,0
1554534869,Hardcover,32,2005,2009,3.91,286,4
014240196X,Paperback,40,2001,2004,4.25,286,3
0060273208,Hardcover,32,1997,1997,4.09,286,0
1681195062,Hardcover,32,2018,2018,3.91,285,0
1582463859,Hardcover,32,2011,2011,3.5,285,0
0761459464,Hardcover,24,2011,2011,3.86,285,0
0803729537,Hardcover,32,2006,2006,4.14,285,0
1581342101,Hardcover,32,2000,2000,4.56,285,0
0590422715,Paperback,40,1983,1989,4.04,285,6
055353744X,Hardcover,32,2017,2017,3.65,284,0
1423178319,Hardcover,32,2013,2013,3.73,284,0
1599901536,Hardcover,32,2005,2007,4.02,284,2
0064436225,Paperback,32,1985,2005,3.83,284,20
014056425X,Paperback,32,1950,1998,4.01,284,48
0060271574,Hardcover,32,1963,1996,3.85,284,33
0888999941,Hardcover,32,2010,2010,3.68,284,0
1907967508,Hardcover,32,2013,2013,3.6,283,0
0395669537,Paperback,40,1990,1993,4.17,283,3
1613778945,Paperback,120,2013,2014,3.93,283,1
080509587X,Hardcover,40,2015,2015,3.33,282,0
0553508067,Board Book,22,2015,2015,4.02,282,0
0439587530,Hardcover,32,2012,2012,3.55,282,0
0688178405,Hardcover,40,2003,2003,3.99,282,0
1338572318,Hardcover,32,2020,2020,4.55,281,0
0525553819,Hardcover,40,2019,2019,4.11,281,0
1402757190,Hardcover,32,2009,2009,4.14,281,0
0763621633,Hardcover,192,2007,2007,3.83,281,0
0374444838,Paperback,32,1967,2002,4.26,281,35
006055505X,Hardcover,32,2009,2010,3.56,280,1
1416916296,Hardcover,48,2008,2008,4.18,280,0
0802789358,Hardcover,32,2005,2005,3.95,280,0
1368020046,Hardcover,32,2019,2019,3.73,279,0
076369634X,Hardcover,32,2018,2018,3.88,279,0
1943200475,Hardcover,48,2017,2017,4.39,279,0
1402758375,Hardcover,32,2011,2011,3.66,279,0
1250308984,Board Book,22,2018,2018,3.68,278,0
152477166X,Hardcover,32,2017,2017,4.1499999999999995,278,0
0763669830,Hardcover,32,2015,2015,3.47,278,0
1405315539,Hardcover,80,2001,2006,4.13,278,5
1929132506,Hardcover,26,2002,2003,4.5,278,1
0374386714,Hardcover,32,1984,2003,4.1,278,19
061838006X,Paperback,32,2001,2003,3.72,278,2
039925174X,Hardcover,40,2008,2008,4.03,277,0
0312561563,Hardcover,112,2010,2010,3.89,277,0
1419723006,Hardcover,32,2017,2017,3.84,276,0
0374304025,Hardcover,32,2017,2017,3.78,276,0
0545100410,Hardcover,32,2013,2013,4.1899999999999995,276,0
0486283534,Paperback,96,1913,1995,4.119999999999999,276,82
1510714693,Hardcover,32,2017,2017,3.78,275,0
0763661740,Hardcover,32,2012,2012,3.97,275,0
0761319417,Hardcover,32,2003,2003,4.05,275,0
1338608894,Hardcover,36,2019,2019,3.88,274,0
1626727686,Paperback,128,2017,2017,4.23,274,0
0571307884,Paperback,32,2015,2015,3.89,274,0
1459801075,Hardcover,32,2013,2013,3.86,274,0
0802796680,Hardcover,48,2013,2013,3.91,274,0
1584302437,Hardcover,32,2005,2005,4.31,274,0
1596436514,Hardcover,40,2015,2015,3.76,274,0
0979923832,Hardcover,32,2008,2008,2.86,274,0
1492638323,Hardcover,32,2020,2020,3.88,273,0
1524771287,Hardcover,40,2020,2020,3.7,273,0
1534406808,Hardcover,32,2018,2018,3.54,273,0
0062408704,Hardcover,40,2017,2017,3.59,273,0
1681190710,Board Book,32,2016,2016,3.66,273,0
0805099018,Hardcover,32,2014,2014,3.53,273,0
1402767994,Hardcover,20,1992,2010,4,273,18
0060591269,Hardcover,32,2006,2006,4.05,273,0
0316115347,Paperback,32,1993,1997,4.109999999999999,273,4
1879794853,Paperback,110,2011,2011,4,273,0
2205061852,Hardcover,48,2009,2009,4.02,273,0
0192722107,Paperback,32,1989,1990,3.71,273,1
0152006001,Hardcover,32,1989,1989,4.24,273,0
0375966552,Hardcover,40,2013,2014,3.85,272,1
0805091971,Hardcover,32,2013,2013,3.83,272,0
0789210584,Hardcover,28,2010,2010,4.15,272,0
1570914613,Paperback,28,2010,2010,3.32,272,0
054504216X,Hardcover,32,2009,2009,3.67,272,0
015205765X,Hardcover,32,2008,2008,3.78,272,0
0399231595,Hardcover,32,2000,2000,3.57,272,0
0099400529,Paperback,32,1987,1999,4.18,272,12
1481487590,Hardcover,40,2019,2019,4.23,271,0
0062560115,Hardcover,48,2017,2018,4.2,271,1
0316184020,Hardcover,44,2014,2014,3.89,271,0
0763632929,Board Book,24,2003,2007,3.97,271,4
1405215186,Hardcover,48,2004,2004,4.319999999999999,271,0
006028384X,Hardcover,32,2000,2000,3.68,271,0
1559420286,Hardcover,30,1992,1992,4.28,271,0
0156705001,Paperback,32,1957,1973,4.25,271,16
0670012688,Hardcover,40,2012,2012,3.73,271,0
0395586356,Hardcover,184,1966,1991,3.69,271,25
0399558152,Hardcover,32,2019,2019,3.58,270,0
1250046424,Hardcover,32,2014,2014,3.89,270,0
1589251016,Hardcover,30,2010,2011,4.04,270,1
0142406864,Paperback,32,2004,2006,4.04,270,2
0763620661,Hardcover,14,2004,2004,4.01,270,0
0064430847,Paperback,48,1979,1985,4.2,270,6
0192790048,Hardcover,30,1996,1997,4.21,270,1
1624146546,Hardcover,40,2019,2019,4.52,269,0
0152055614,Hardcover,32,2004,2005,4.06,269,1
0689846800,Hardcover,40,2004,2004,4.26,269,0
0440417430,Paperback,40,1997,2001,4.03,269,4
1608865762,Paperback,128,2010,2010,4.21,269,0
0942235738,Hardcover,32,2007,2007,4.2700000000000005,269,0
0553508350,Hardcover,40,2016,2016,3.85,268,0
1609050169,Hardcover,40,2010,2010,3.75,268,0
0061239135,Hardcover,40,2007,2007,3.57,268,0
0316119555,Paperback,32,1996,1998,4.14,268,2
0140546103,Paperback,32,1971,1993,4.17,268,22
2205049690,Hardcover,48,1996,1996,4.03,268,0
0062560778,Hardcover,40,2018,2018,4.2700000000000005,267,0
0425290115,Hardcover,32,2017,2017,3.47,267,0
0763622397,Hardcover,48,1887,2004,4.09,267,117
0689815115,Hardcover,32,2002,2002,4.109999999999999,267,0
0062242652,Hardcover,32,2013,2014,3.52,266,1
0807505099,Hardcover,24,2013,2013,3.47,266,0
0805079912,Hardcover,32,2007,2012,3.54,266,5
1596439165,Paperback,96,2015,2015,3.75,266,0
0152023658,Paperback,36,1989,2000,3.92,266,11
0140567445,Paperback,40,1974,2000,3.85,266,26
0374335303,Hardcover,40,2014,2014,3.65,265,0
141692440X,Hardcover,40,2007,2007,4.2,265,0
076362408X,Paperback,32,2002,2007,3.93,265,5
0374335273,Hardcover,40,2005,2005,4.25,265,0
0689863292,Hardcover,32,2004,2004,4.119999999999999,265,0
015204597X,Paperback,48,1998,2003,3.91,265,5
0439110165,Hardcover,32,2002,2002,4.14,265,0
0688065198,Paperback,40,1979,1986,4.18,265,7
0374410380,Paperback,32,1977,1986,3.91,265,9
1419731637,Hardcover,32,2019,2019,3.98,264,0
0374300194,Hardcover,34,2015,2015,3.94,264,0
1423162382,Hardcover,40,2013,2013,3.54,264,0
0152163506,Paperback,32,1998,2002,4.05,264,4
1782765573,Hardcover,48,2015,2015,3.67,264,0
1554537517,Hardcover,80,2012,2012,3.59,264,0
2302007689,Paperback,48,2009,2009,4.26,264,0
0698113543,Paperback,48,1987,1998,4.09,264,11
1481464655,Hardcover,34,2018,2018,3.67,263,0
054493539X,Hardcover,40,2017,2017,4.159999999999999,263,0
0794518907,Board Book,10,2007,2008,3.97,263,1
1302902245,Hardcover,248,2016,2016,4.35,263,0
1419716530,Hardcover,32,2016,2016,3.73,262,0
0807544000,Hardcover,24,2013,2013,3.67,262,0
0152050728,Hardcover,44,2013,2013,4.04,262,0
0763646105,Hardcover,40,2009,2009,3.72,262,0
1570914370,Hardcover,32,2006,2006,4.08,262,0
0531070565,Paperback,32,1990,1994,3.91,262,4
0140547517,Paperback,32,1986,1992,4.3,262,6
0689713835,Paperback,32,1980,1990,3.95,262,10
0688842917,Hardcover,32,1981,1981,3.69,262,0
0060987626,Paperback,144,1999,1999,3.84,262,0
0618003614,Hardcover,32,2005,2005,4.03,261,0
1558582614,Hardcover,49,1826,1994,4.18,261,168
0803741596,Hardcover,32,2016,2016,3.15,260,0
1589258525,Hardcover,32,2011,2011,3.78,260,0
1616554142,Paperback,128,2013,2014,3.65,260,1
0316769061,Hardcover,32,2001,2001,4.119999999999999,260,0
1570982082,Paperback,40,1973,1998,3.94,260,25
0763677329,Hardcover,32,2017,2017,3.89,259,0
0007149697,Paperback,32,2002,2003,4.359999999999999,259,1
0152321977,Hardcover,32,2000,2000,3.8,259,0
1548116815,Kindle Edition,28,2017,2017,4.21,258,0
1423134001,Hardcover,32,2011,2011,3.89,258,0
0374380007,Hardcover,112,2011,2011,3.71,258,0
0316366641,Hardcover,32,2006,2006,3.74,258,0
0064433951,Paperback,32,1993,1995,4.28,258,2
0385373112,Hardcover,32,2014,2014,3.15,257,0
0062014226,Hardcover,40,2013,2013,3.53,257,0
275601558X,Hardcover,47,2008,2009,4.09,257,1
0374305064,Hardcover,32,2018,2018,3.91,256,0
080509976X,Hardcover,40,2015,2015,4.1,256,0
0735842396,Hardcover,32,2013,2015,3.61,256,2
1561456209,Hardcover,32,2012,2012,3.95,256,0
0375866639,Hardcover,32,2011,2011,4.29,256,0
1596435038,Hardcover,64,2008,2009,3.98,256,1
0763626007,Paperback,48,2000,2007,4.3,256,7
0141388501,Hardcover,64,2019,2019,4.42,256,0
0399186581,Hardcover,224,2018,2018,4.25,256,0
014054724X,Paperback,32,1977,1992,4.109999999999999,256,15
1680100386,Hardcover,32,2017,2017,4.06,255,0
0547449216,Hardcover,48,2017,2017,4.119999999999999,255,0
1416986340,Hardcover,24,2011,2011,3.54,255,0
1929766831,Hardcover,24,2003,2003,3.94,255,0
0762443545,Hardcover,32,2012,2012,3.79,254,0
0618997180,Hardcover,32,2009,2009,3.89,254,0
0786838337,Hardcover,32,1997,2006,4.1,254,9
1596793449,Hardcover,40,1967,2005,3.7,254,38
0761451625,Hardcover,32,2005,2005,3.89,254,0
0689869916,Paperback,32,2001,2004,4.07,254,3
0060286423,Hardcover,64,1965,2001,3.74,254,36
068981965X,Hardcover,40,2001,2001,3.97,254,0
0399228179,Hardcover,32,1995,1995,3.63,254,0
1603090576,Hardcover,36,2010,2010,3.65,254,0
0316302570,Hardcover,32,2015,2015,4.08,253,0
0719554888,Hardcover,57,2005,2005,4.05,253,0
1101934573,Hardcover,32,2014,2016,4,253,2
1627797750,Hardcover,32,2017,2017,3.54,252,0
0803741324,Hardcover,32,2016,2016,3.52,252,0
0553510614,Hardcover,40,2015,2015,3.48,252,0
0805088849,Hardcover,40,2011,2011,3.72,252,0
1884734995,Hardcover,32,2010,2011,4.2,252,1
0972125914,Paperback,220,2003,2003,4.109999999999999,252,0
0380715643,Paperback,160,1992,1993,3.8,252,1
0440841313,Paperback,42,1978,1978,4.42,252,0
152471464X,Hardcover,40,2018,2018,3.65,251,0
0763694975,Hardcover,32,2016,2016,3.56,251,0
0385373279,Ebook,44,2016,2016,3.61,251,0
0802855091,Hardcover,48,2015,2015,4.25,251,0
0763623075,Board Book,24,2002,2004,3.69,251,2
1930900147,Hardcover,32,1955,2002,4.24,251,47
0763635707,Paperback,32,1988,2007,4.18,251,19
0062452959,Hardcover,48,2017,2017,3.88,250,0
1442412615,Hardcover,40,2016,2016,3.53,250,0
0761351531,Hardcover,26,2009,2009,4.109999999999999,250,0
0140549110,Paperback,32,1985,1992,4.05,250,7
133825183X,Hardcover,128,2019,2019,4.38,250,0
1732569991,Hardcover,350,2018,2018,4.26,250,0
1421541165,Paperback,272,2012,2012,4.1,250,0
0062683128,Hardcover,32,2018,2018,3.33,249,0
0545708222,Hardcover,32,2013,2014,3.93,249,1
0517551225,Paperback,32,1975,2010,3.98,249,35
0448445697,Paperback,32,2007,2007,4.08,249,0
0689856857,Hardcover,32,2004,2004,3.85,249,0
4061272748,Hardcover,31,1977,1977,4.34,249,0
1499803508,Hardcover,32,2016,2016,3.82,248,0
0525428178,Hardcover,40,2016,2016,3.61,248,0
076365955X,Hardcover,32,2014,2014,3.78,248,0
0375866841,Hardcover,40,2010,2010,3.81,248,0
0810983982,Hardcover,32,2010,2010,3.95,248,0
0794502105,Board Book,10,2002,2008,3.82,248,6
0805078827,Paperback,32,2002,2005,4.29,248,3
0763624764,Hardcover,40,2004,2004,3.65,248,0
0316702781,Hardcover,40,2004,2004,4.34,248,0
0060264950,Hardcover,32,1958,1958,3.92,248,0
2205049704,Hardcover,48,1997,1997,4.07,248,0
1402789556,Board Book,18,2012,2012,4.11,247,0
0689851707,Hardcover,40,2005,2005,4.2,247,0
0786806435,Hardcover,32,2002,2002,4.18,247,0
0688122752,Paperback,32,1989,1993,3.64,247,4
1626724083,Paperback,128,2017,2017,4.23,247,0
0064440958,Paperback,64,1961,1986,3.76,247,25
1452141347,Hardcover,60,2018,2018,4.33,246,0
0152056645,Hardcover,32,2007,2007,3.93,246,0
0525478574,Hardcover,24,2007,2007,3.9,246,0
0006645984,Paperback,32,1990,1996,4.3,246,6
0590321978,Paperback,112,1960,1988,3.79,246,28
0395453577,Paperback,32,1986,1987,3.96,246,1
1848779437,Hardcover,48,2013,2013,3.73,245,0
1467745227,Hardcover,32,2014,2014,3.2,245,0
1888472367,Paperback,144,2006,2006,4.28,245,0
1524787043,Hardcover,40,2020,2020,3.91,244,0
0763692611,Hardcover,32,2017,2017,3.71,244,0
1620916509,Hardcover,40,2016,2016,4.06,244,0
0689858353,Hardcover,32,2004,2004,3.42,244,0
1897299699,Paperback,152,2009,2009,3.77,244,0
0061950904,Hardcover,32,2013,2013,3.87,243,0
0762420480,Hardcover,32,1977,2009,4.26,243,32
0803728816,Hardcover,32,1969,2003,4.119999999999999,243,34
0399235973,Board Book,12,1983,2003,3.8,243,20
0399216170,Hardcover,32,1989,1989,4.07,243,0
0141339799,Kindle Edition,480,2014,2014,4.8,243,0
1101996447,Hardcover,32,2018,2018,3.7,242,0
1442465115,Hardcover,48,2017,2017,3.49,242,0
0679435824,Hardcover,96,1994,1994,4.119999999999999,242,0
0062689886,Hardcover,32,2019,2019,4,241,0
1939547172,Hardcover,40,2015,2015,4.109999999999999,241,0
0399256881,Hardcover,32,2012,2012,3.89,241,0
0547575319,Hardcover,40,2011,2011,3.46,241,0
0689846762,Hardcover,32,2001,2001,4.13,241,0
043922229X,Paperback,32,2001,2001,3.84,241,0
097778830X,Paperback,112,2006,2006,3.65,241,0
1620145871,Hardcover,48,2019,2019,4.41,240,0
0786803711,Hardcover,32,2008,2008,3.93,240,0
159643273X,Hardcover,32,2008,2008,3.53,240,0
0786804955,Hardcover,32,2000,2000,4.25,240,0
2756019933,Hardcover,48,2010,2010,4.1899999999999995,240,0
0525580298,Hardcover,32,2019,2019,3.73,239,0
1452128995,Board Book,16,2014,2014,3.98,239,0
1561486361,Hardcover,32,2008,2013,3.98,239,5
1452106649,Hardcover,40,2012,2012,3.79,239,0
1442408081,Hardcover,32,2011,2011,3.54,239,0
0805077138,Hardcover,40,2007,2007,4.04,239,0
0448442000,Hardcover,64,1961,1978,4.35,239,17
1597072540,Hardcover,48,2008,2012,3.67,239,4
1563897482,Paperback,320,2000,2000,3.88,239,0
1984830538,Hardcover,40,2019,2019,3.75,238,0
0399555625,Hardcover,32,2017,2017,3.62,238,0
0763679178,Hardcover,40,2015,2015,3.92,238,0
0316255580,Hardcover,40,2013,2013,4.14,238,0
0807549908,Hardcover,32,2013,2013,3.82,238,0
1564022714,Paperback,32,1992,1994,4.07,238,2
145492666X,Hardcover,40,2018,2018,4.109999999999999,237,0
1419709518,Board Book,24,2014,2014,4.06,237,0
1553377680,Paperback,32,2003,2004,4.08,237,1
0823410781,Paperback,32,1993,1993,4.1899999999999995,237,0
1481430750,Hardcover,40,2018,2018,3.73,236,0
0374351317,Hardcover,40,2015,2015,3.67,236,0
0670011797,Hardcover,32,2011,2011,3.91,236,0
1534400141,Hardcover,32,2018,2018,3.83,235,0
1419703552,Hardcover,56,2012,2012,4.1,235,0
0061440221,Hardcover,48,2007,2007,4.06,235,0
1584690925,Paperback,32,2007,2007,4.1,235,0
0689863594,Paperback,32,2000,2003,3.92,235,3
043940469X,Paperback,32,2003,2003,3.79,235,0
1596432934,Paperback,128,2012,2012,3.86,235,0
0142403644,Paperback,32,2003,2005,3.9,235,2
068805823X,Hardcover,28,1985,1985,4.109999999999999,235,0
0006014791,Paperback,37,1960,1960,4.1899999999999995,235,0
0192762818,Paperback,180,1954,1954,4.02,235,0
0451481178,Hardcover,32,2019,2019,3.96,234,0
0545880157,Hardcover,32,2017,2017,3.74,234,0
1404867864,Board Book,18,2011,2011,3.83,234,0
0823406172,Hardcover,32,1987,1987,3.91,234,0
0140503250,Paperback,32,1965,1978,3.8,234,13
0714874086,Board Book,40,2017,2017,3.95,233,0
1630833169,Paperback,36,2014,2014,4.21,233,0
0590021745,Paperback,32,1971,1972,4.41,233,1
0449810194,Paperback,96,2013,2013,3.93,233,0
0525422153,Hardcover,32,2010,2010,4.1,233,0
0914378058,Paperback,126,1949,1960,3.85,233,11
1620916312,Hardcover,40,2015,2015,3.66,232,0
1592701825,Hardcover,40,2015,2015,3.57,232,0
0375856064,Hardcover,40,2014,2014,4.1,232,0
1590787218,Hardcover,32,2012,2012,3.93,232,0
1896764096,Paperback,24,1999,2010,3.94,232,11
1404857265,Board Book,18,2010,2010,3.63,232,0
0439879930,Hardcover,32,2008,2008,3.36,232,0
039572287X,Hardcover,32,1999,1999,4.09,232,0
0590421174,Paperback,32,1974,1988,4.06,232,14
0416886000,Paperback,36,1977,1980,4.22,232,3
2205054759,Hardcover,48,2003,2003,4.05,232,0
0374316783,Hardcover,32,2002,2002,4.07,232,0
1250304407,Hardcover,32,2019,2019,3.4499999999999997,231,0
141972536X,Hardcover,32,2017,2017,3.84,231,0
0807516996,Hardcover,32,2017,2017,3.59,231,0
1101936622,Hardcover,40,2016,2016,3.4499999999999997,231,0
0823423166,Hardcover,40,2011,2011,3.52,231,0
1402716249,Hardcover,26,2003,2004,4.23,231,1
0803727402,Hardcover,32,2004,2004,3.66,231,0
0060526718,Hardcover,48,2003,2003,3.85,231,0
0761356290,Paperback,48,2010,2011,4.09,231,1
2205063715,Hardcover,48,2010,2010,4.06,231,0
1575421801,Board Book,24,2005,2005,4.03,231,0
0671667459,Paperback,32,1974,1985,4.01,231,11
0544586522,Hardcover,32,2017,2017,3.4,230,0
1592702015,Hardcover,48,2016,2016,3.57,230,0
044041766X,Paperback,40,2000,2002,4.01,230,2
0860208648,Hardcover,40,1985,2000,4.24,230,15
0531301486,Hardcover,32,1999,1999,3.94,230,0
0688147402,Paperback,32,1986,1996,3.72,230,10
0670851124,Hardcover,40,1995,1995,4.159999999999999,230,0
0340246367,Paperback,32,1979,1992,3.99,230,13
220504902X,Hardcover,48,2000,2000,4.1,230,0
0689807597,Hardcover,40,1997,1997,4.01,230,0
0140558543,Paperback,32,1993,1997,4.24,230,4
0062269879,Hardcover,32,2018,2018,3.83,229,0
0451469917,Hardcover,32,2015,2015,3.28,229,0
1589250591,Hardcover,32,2006,2006,3.6,229,0
0152053085,Board Book,30,2001,2005,3.86,229,4
0763620351,Board Book,26,1999,2003,3.79,229,4
0316099511,Hardcover,32,1992,1992,4.29,229,0
0437794105,Hardcover,32,1972,1973,4.2,229,1
8484645649,Hardcover,36,1993,2000,4.13,229,7
145631579X,Hardcover,48,1962,1962,4.51,229,0
1627794417,Hardcover,34,2018,2018,3.86,228,0
1633450392,Hardcover,40,2017,2017,3.9,228,0
080508794X,Hardcover,40,2016,2016,3.32,228,0
0061714860,Hardcover,40,2010,2010,3.85,228,0
0843176482,Paperback,32,1978,2001,4,228,23
0152018883,Paperback,36,1995,1998,4.04,228,3
1559712252,Hardcover,32,1994,1994,4.35,228,0
1626720525,Hardcover,48,2014,2014,3.64,228,0
0544648323,Hardcover,32,2018,2018,3.9,227,0
1492618810,Hardcover,32,2016,2016,3.75,227,0
0805094350,Hardcover,32,2014,2014,3.58,227,0
0152050469,Hardcover,40,2006,2006,3.85,227,0
0375848223,Hardcover,22,1951,1954,3.97,227,3
0689713355,Paperback,32,1966,1989,4.08,226,23
0873519663,Hardcover,32,2015,2015,4.02,226,0
2205056360,Hardcover,48,2005,2005,4.01,226,0
2205049712,Hardcover,48,1998,1998,4.06,226,0
1459816145,Hardcover,32,2019,2019,4.33,225,0
1561459135,Hardcover,40,2017,2017,4.17,225,0
0064432084,Paperback,32,1976,2002,4.07,225,26
0688170676,Paperback,40,1997,2001,4.09,225,4
1524765880,Hardcover,48,2018,2018,3.87,224,0
1910716235,Hardcover,32,2017,2017,3.64,224,0
1442460377,Hardcover,32,2013,2013,3.63,224,0
0761452346,Hardcover,64,2005,2005,4.13,224,0
0746007949,Paperback,24,1986,2002,4.01,224,16
0688143938,Paperback,48,1981,1995,3.89,224,14
0590466631,Paperback,32,1994,1994,3.86,224,0
0763664928,Hardcover,56,2015,2015,3.68,223,0
080507905X,Hardcover,32,2007,2007,3.66,223,0
1563979322,Hardcover,32,2001,2001,3.8,223,0
0525462619,Hardcover,36,1999,1999,4,223,0
156402976X,Paperback,48,1994,1996,4.359999999999999,223,2
1564020665,Hardcover,32,1994,1994,4.22,223,0
0684125064,Hardcover,32,1971,1971,3.85,223,0
1596433787,Hardcover,32,2013,2013,3.8,223,0
0805077340,Hardcover,32,2007,2007,3.69,223,0
0385327269,Hardcover,146,2000,2000,4.13,223,0
1524717371,Hardcover,32,2017,2017,3.7,222,0
1419720708,Hardcover,32,2016,2016,3.83,222,0
0375858806,Hardcover,40,2000,2010,3.75,222,10
0805072330,Hardcover,32,2005,2005,3.73,222,0
0374346992,Hardcover,40,2002,2002,4.01,222,0
0413745902,Hardcover,125,1948,2001,4.14,222,53
1534439110,Hardcover,336,2019,2019,3.82,222,0
1590174615,Hardcover,136,1954,2011,4.359999999999999,222,57
0670059099,Hardcover,32,1975,2004,4.41,222,29
1484749553,Hardcover,48,2020,2020,3.82,221,0
039917074X,Hardcover,32,2019,2019,3.95,221,0
1509837329,Hardcover,32,2017,2017,4.1499999999999995,221,0
080509170X,Hardcover,40,2015,2015,3.84,221,0
1561453781,Hardcover,32,2004,2006,3.85,221,2
0375804757,Board Book,26,1961,2001,4.38,221,40
0786811641,Paperback,40,1995,1999,4,221,4
0698116070,Paperback,32,1995,1998,4.14,221,3
1481471473,Hardcover,32,2016,2016,3.58,220,0
1404867872,Board Book,20,2012,2012,3.72,220,0
1894965140,Hardcover,32,2003,2005,3.87,220,2
0698118847,Paperback,48,1998,2001,3.8,220,3
0698114345,Paperback,32,1986,1997,4.55,220,11
0763601330,Hardcover,96,1937,1997,4.2700000000000005,220,60
1101937211,Hardcover,40,2016,2016,3.72,219,0
0618473106,Hardcover,32,2006,2006,3.66,219,0
0807588377,Hardcover,32,1995,1995,4.14,219,0
0374399247,Hardcover,40,2008,2008,3.99,219,0
1681195070,Hardcover,32,2018,2018,3.78,218,0
1582463433,Hardcover,40,2011,2011,3.92,218,0
1580890229,Hardcover,32,1999,2002,3.94,218,3
0590058991,Board Book,12,1997,1997,4.09,218,0
0399544844,Board Book,24,2015,2016,3.82,217,1
1416986316,Hardcover,24,2009,2010,3.58,217,1
0316058300,Hardcover,32,2009,2010,4.06,217,1
0375822631,Board Book,32,1946,2002,3.55,217,56
0399162402,Hardcover,32,2015,2015,3.82,217,0
0786949759,Hardcover,80,2008,2008,4.3,217,0
0374405700,Paperback,32,1971,1986,4.08,217,15
1585369861,Hardcover,32,2017,2017,4.1899999999999995,216,0
0763675962,Hardcover,32,2014,2015,3.71,216,1
0525474560,Hardcover,32,2005,2013,3.54,216,8
1442435119,Ebook,32,2013,2013,3.89,216,0
1934706280,Hardcover,40,2008,2008,3.7,216,0
0374310858,Hardcover,28,2008,2008,4.1,216,0
1590171543,Hardcover,32,1954,2005,4.13,216,51
9044832824,Hardcover,64,2018,2018,4.619999999999999,216,0
1250120365,Hardcover,32,2019,2019,4.33,215,0
0553520679,Hardcover,40,2016,2016,3.83,215,0
0805099328,Hardcover,32,2015,2015,3.93,215,0
1600604390,Hardcover,32,2011,2011,4.21,215,0
0689852649,Hardcover,48,2003,2003,3.94,215,0
0374469032,Paperback,32,1985,1987,3.93,215,2
1595822402,Hardcover,272,2009,2009,4.24,215,0
156163056X,Hardcover,48,1992,1992,3.97,215,0
0590479903,Paperback,32,1994,1994,4.35,214,0
039925658X,Paperback,224,2012,2012,4.24,214,0
1554516250,Hardcover,36,2014,2014,4.26,213,0
1419708015,Hardcover,32,2013,2013,4.23,213,0
1402744617,Hardcover,32,2009,2009,4.08,213,0
0744540674,Paperback,32,2005,2006,4.07,213,1
0786811633,Paperback,32,1960,1997,3.51,213,37
0006627749,Paperback,48,1983,1986,3.91,213,3
039920766X,Hardcover,157,1966,1980,4.42,213,14
1250094062,Hardcover,40,2017,2017,3.63,212,0
076366622X,Hardcover,32,2013,2013,3.85,212,0
2205067656,Hardcover,48,2011,2011,4.01,212,0
0439216419,Paperback,92,2001,2001,3.7,212,0
1930900090,Hardcover,218,1955,2001,4.18,212,46
074456946X,Paperback,40,1998,2000,4.1499999999999995,212,2
1442434147,Hardcover,48,2017,2017,3.62,211,0
0745946542,Paperback,120,1998,2003,4.24,211,5
0679890955,Paperback,32,1994,1998,4.41,211,4
0763698725,Hardcover,32,2018,2018,3.34,210,0
1907967745,Hardcover,32,2014,2014,3.3899999999999997,210,0
085707444X,Paperback,26,2012,2012,3.77,210,0
0099434083,Paperback,32,1984,2003,3.94,210,19
0345330455,Paperback,64,1985,1985,4.1499999999999995,210,0
0448453746,Board Book,12,2010,2010,3.89,210,0
0064405613,Paperback,224,1955,1995,4.01,210,40
1481445022,Hardcover,40,2018,2018,3.71,209,0
1499189613,Paperback,34,2014,2014,3.84,209,0
158536830X,Hardcover,40,2014,2014,3.81,209,0
1561455938,Hardcover,37,2011,2011,4.07,209,0
0448446979,Paperback,24,2008,2008,4.2,209,0
0449810224,Paperback,96,2013,2013,4.03,209,0
088899995X,Hardcover,48,2011,2011,3.74,209,0
0374312672,Hardcover,144,1995,2009,3.84,209,14
043955988X,Paperback,98,2003,2003,3.71,209,0
0375845755,Hardcover,32,2017,2017,3.56,208,0
0805099190,Hardcover,32,2015,2015,3.4499999999999997,208,0
037581079X,Hardcover,56,1938,2003,3.72,208,65
1554535816,Hardcover,96,2011,2011,3.2,208,0
1401261965,Paperback,144,2004,2015,4,207,11
0140546138,Paperback,32,1987,1993,3.96,207,6
1492645869,Hardcover,32,2018,2018,3.95,206,0
0062435817,Board Book,24,2017,2017,3.76,206,0
0375837590,Hardcover,40,2007,2007,3.99,206,0
1481472453,Hardcover,32,2018,2018,3.9,205,0
1524714542,Hardcover,32,2015,2015,3.96,205,0
0805062793,Hardcover,40,2003,2003,3.77,205,0
275602435X,Hardcover,46,2011,2011,3.91,205,0
1596432756,Hardcover,34,2008,2008,4.01,205,0
0803728689,Hardcover,40,2007,2007,4,205,0
1582460574,Paperback,32,1995,2001,4.07,205,6
1101918837,Hardcover,32,2017,2017,4.14,204,0
0385754620,Hardcover,40,2015,2015,3.91,204,0
0811866017,Hardcover,32,2011,2011,3.57,204,0
0888999291,Hardcover,64,2009,2009,3.79,204,0
1934031232,Hardcover,48,1969,2008,4.28,204,39
0345322428,Hardcover,64,1984,1984,4.01,204,0
0397300441,Hardcover,367,1937,1937,4.55,204,0
0807523054,Hardcover,32,2019,2019,3.87,203,0
0062469339,Hardcover,32,2018,2018,3.73,203,0
0803737955,Hardcover,32,2014,2014,3.53,203,0
1416994785,Hardcover,32,2011,2011,3.81,203,0
0618773320,Hardcover,32,2008,2008,3.4299999999999997,203,0
0823416593,Hardcover,32,2005,2005,3.73,203,0
0439683475,Paperback,32,1995,2004,4.01,203,9
0142300160,Paperback,40,1999,2001,4.18,203,2
0152058060,Hardcover,32,2013,2013,3.89,202,0
1451648790,Hardcover,32,2013,2013,3.59,202,0
0061363138,Hardcover,40,2008,2008,3.7,202,0
0439216400,Paperback,96,2001,2001,3.95,202,0
1250140919,Hardcover,32,2019,2019,3.91,201,0
1620141639,Hardcover,40,2018,2018,4.23,201,0
0307730271,Board Book,22,2009,2011,4.28,201,2
0590374877,Hardcover,40,1998,1998,3.91,201,0
0062324357,Hardcover,48,2012,2015,3.19,201,3
1402277407,Hardcover,32,2012,2012,4,201,0
0761356312,Hardcover,32,2007,2007,3.27,201,0
0374456488,Paperback,48,1999,2003,3.82,201,4
0807577677,Hardcover,32,2018,2018,3.98,200,0
0385754965,Hardcover,32,2017,2017,3.47,200,0
0545265045,Paperback,64,2009,2011,3.64,200,2
0312565704,Hardcover,32,2008,2009,3.4099999999999997,200,1
0967290201,Hardcover,32,1991,1999,4.119999999999999,200,8
0590031236,Paperback,184,1940,1963,4.02,200,23
0823443272,Hardcover,32,2019,2019,3.68,199,0
1419719017,Hardcover,32,2016,2016,3.94,199,0
161067362X,Board Book,16,2015,2015,4.54,199,0
0805092420,Hardcover,32,2014,2014,3.36,199,0
1477817247,Hardcover,32,2013,2013,3.85,199,0
0230706487,Paperback,32,2009,2010,3.84,199,1
0374310866,Hardcover,32,2009,2009,4.17,199,0
0763622222,Hardcover,32,2006,2006,3.85,199,0
0688122655,Paperback,40,1984,1993,3.9,199,9
0590004980,Paperback,32,1950,1950,4.17,199,0
1582706883,Kindle Edition,155,2013,2013,4.42,199,0
0823435385,Hardcover,24,2016,2016,3.42,198,0
1423138236,Hardcover,32,2012,2012,3.61,198,0
0618919759,Hardcover,32,2008,2008,3.95,198,0
1582460469,Hardcover,24,2000,2004,3.56,198,4
0525467858,Hardcover,32,1937,2003,3.8,198,66
0439110149,Hardcover,28,2000,2000,4.05,198,0
0964456303,Hardcover,64,1995,1995,4.2700000000000005,198,0
0544226208,Hardcover,48,2017,2017,4.08,197,0
1404867899,Board Book,20,2011,2011,3.51,197,0
0794502822,Hardcover,64,1995,2003,4.07,197,8
1626720193,Hardcover,28,2012,2014,3.66,197,2
3939435805,Hardcover,40,2013,2013,4.34,197,0
0394834550,Paperback,32,1977,2008,4.119999999999999,197,31
0879235268,Hardcover,32,1969,1994,4.4,197,25
0062644564,Hardcover,40,2019,2019,3.7,196,0
0763679305,Hardcover,32,2018,2018,3.52,196,0
0735228760,Hardcover,26,2017,2017,3.55,196,0
1419709542,Board Book,24,2014,2014,3.95,196,0
0823422143,Hardcover,32,2010,2010,3.88,196,0
0399251804,Hardcover,32,2009,2009,3.85,196,0
1419723154,Paperback,192,2017,2017,3.85,196,0
1401235255,Paperback,128,2012,2012,4.109999999999999,196,0
043910839X,Hardcover,32,2000,2000,4.14,196,0
0689834136,Hardcover,22,2000,2000,4.06,196,0
0152842802,Hardcover,64,1963,1991,4.06,196,28
1534427228,Hardcover,32,2020,2020,4.38,195,0
0525552715,Hardcover,32,2019,2019,3.52,195,0
1524765171,Hardcover,32,2018,2018,3.75,195,0
1419728393,Hardcover,48,2018,2018,4.29,195,0
1681192012,Hardcover,22,2017,2017,3.83,195,0
0689878877,Hardcover,48,2015,2015,3.78,195,0
0439793386,Hardcover,56,2015,2015,3.91,195,0
1408300761,Hardcover,32,2011,2011,4.1899999999999995,195,0
1442401974,Hardcover,40,2011,2011,3.65,195,0
0689307977,Hardcover,38,1980,1980,4.35,195,0
1597074128,Paperback,124,2011,2013,3.95,195,2
2756024732,Hardcover,42,2012,2012,3.96,195,0
0590478877,Hardcover,40,1998,1998,4.31,195,0
1541543831,Ebook,32,2019,2019,4.319999999999999,194,0
0374306419,Hardcover,32,2019,2019,3.4,194,0
1250155320,Hardcover,40,2019,2019,3.91,194,0
0843183004,Hardcover,32,2016,2016,3.67,194,0
0888999275,Board Book,16,2008,2009,4.39,194,1
1416971270,Hardcover,32,2008,2008,4.06,194,0
014055260X,Paperback,32,1973,1993,4.04,194,20
014056408X,Paperback,32,1994,1998,4.1,194,4
1250303184,Hardcover,48,2020,2020,4.2,193,0
1454921196,Hardcover,32,2019,2019,4.109999999999999,193,0
0061175986,Hardcover,32,2017,2017,3.68,193,0
0385390173,Hardcover,44,2017,2017,3.52,193,0
0763681474,Hardcover,32,2016,2016,3.58,193,0
0735840008,Hardcover,32,2011,2011,3.76,193,0
1582463263,Hardcover,32,2011,2011,4.06,193,0
0618158367,Hardcover,48,2008,2008,3.91,193,0
0060011076,Hardcover,40,2005,2005,4.13,193,0
0698118634,Paperback,32,1997,2000,3.79,193,3
0979894042,Paperback,321,1929,2008,4.03,193,79
2205049879,Hardcover,49,2001,2001,4.03,193,0
0440415837,Paperback,144,1965,1999,3.87,193,34
1888444584,Hardcover,32,1999,1999,3.96,193,0
0544749820,Hardcover,40,2018,2018,3.55,192,0
0545647959,Hardcover,32,2014,2014,3.38,192,0
1477817220,Hardcover,13,2013,2013,3.64,192,0
1416979611,Hardcover,32,2011,2011,3.75,192,0
1400318084,Board Book,14,1997,2011,4.28,192,14
1582463697,Hardcover,32,2011,2011,4.06,192,0
0374370095,Hardcover,32,2008,2008,3.68,192,0
1607060876,Paperback,96,2009,2009,4.18,192,0
0670016349,Hardcover,32,2014,2014,4.109999999999999,191,0
0698116690,Paperback,40,1992,1998,3.88,191,6
019272908X,Hardcover,28,2009,2010,4.33,191,1
078513316X,Paperback,120,2008,2008,3.74,191,0
1599150697,Paperback,188,1857,2007,3.98,191,150
1534438947,Hardcover,56,2019,2019,4.54,190,0
0823438597,Hardcover,32,2018,2018,3.62,190,0
0399557970,Hardcover,48,2017,2017,3.48,190,0
1101995815,Hardcover,64,2016,2016,4.01,190,0
0152064206,Hardcover,40,2009,2009,3.89,190,0
0590738860,Paperback,30,1996,1999,4.18,190,3
0823409503,Paperback,32,1990,1990,3.95,190,0
0374303908,Paperback,32,1989,2001,4.34,190,12
1419723464,Hardcover,24,2017,2017,3.63,189,0
0399254048,Hardcover,40,2016,2016,3.77,189,0
1426311087,Hardcover,48,2014,2014,4.02,189,0
0803733208,Hardcover,32,2012,2012,3.42,189,0
9681670469,Paperback,48,2003,2004,4.35,189,1
0816642419,Hardcover,32,1929,2003,4.06,189,74
162672752X,Paperback,128,2017,2017,3.95,189,0
0763664359,Hardcover,38,2012,2013,3.8,188,1
0811840476,Board Book,22,2003,2003,4.09,188,0
1477820361,Hardcover,24,2015,2015,3.71,187,0
0805077405,Hardcover,32,2006,2006,3.76,187,0
0439043948,Paperback,32,1999,1999,3.76,187,0
0698115643,Paperback,32,1994,1997,4.03,187,3
1609805305,Paperback,470,2014,2014,3.87,187,0
1936975688,Paperback,104,2013,2013,4.21,187,0
2205071270,Hardcover,48,2013,2013,4.04,187,0
0810957302,Hardcover,352,2009,2009,4.08,187,0
0544798759,Hardcover,40,2018,2018,3.7,186,0
0060780053,Hardcover,38,2016,2016,3.86,186,0
0553510584,Hardcover,40,2014,2015,3.66,186,1
0803733097,Hardcover,40,2009,2009,3.38,186,0
1421552752,Paperback,192,2012,2013,3.58,186,1
0753465019,Paperback,128,2011,2011,4.23,186,0
1984830082,Hardcover,32,2020,2020,3.64,185,0
1616895055,Hardcover,90,2007,2018,3.28,185,11
0374301298,Hardcover,32,2015,2015,3.65,185,0
0786856750,Hardcover,32,2002,2005,3.96,185,3
0688513115,Hardcover,48,1967,1967,4.55,185,0
0721400825,Hardcover,52,1966,1966,3.62,185,0
1626723605,Paperback,128,2016,2016,3.62,185,0
1401225063,Paperback,144,2008,2009,3.61,185,1
0064450651,Paperback,32,1960,1987,3.96,185,27
1596438630,Hardcover,40,2014,2014,3.92,184,0
0310731151,Hardcover,32,2007,2014,4,184,7
006114245X,Hardcover,32,2011,2011,3.82,184,0
0547239998,Hardcover,32,2010,2010,3.67,184,0
141694088X,Hardcover,40,2009,2009,3.6,184,0
0805079572,Hardcover,80,2007,2007,3.85,184,0
1405203323,Hardcover,64,1946,2004,3.92,184,58
0689845987,Hardcover,32,2002,2002,3.74,184,0
1553373863,Hardcover,28,2002,2002,4.13,184,0
0590401955,Paperback,32,1987,1987,4.4,184,0
0805018484,Paperback,32,1812,1991,3.98,184,179
0805006826,Hardcover,32,1988,1988,3.78,184,0
076416581X,Hardcover,32,2012,2012,4.1,183,0
0061177547,Hardcover,32,2010,2010,3.72,183,0
0688180205,Hardcover,40,1991,2001,3.95,183,10
1561451479,Paperback,40,1991,1997,4.159999999999999,183,6
1600608477,Hardcover,32,2013,2013,3.83,183,0
1409562921,Hardcover,328,1992,2013,4.5,182,21
1582463298,Hardcover,32,2010,2010,3.47,182,0
0395912040,Hardcover,32,2000,2000,3.4499999999999997,182,0
0395884152,Hardcover,32,1998,1998,3.72,182,0
1416970959,Hardcover,40,2012,2012,3.52,182,0
076363686X,Hardcover,40,2007,2007,4.23,182,0
0525473688,Hardcover,32,2005,2005,3.73,181,0
0811837726,Hardcover,40,2004,2004,3.55,181,0
0375810722,Hardcover,56,1962,2001,3.9,181,39
0590543318,Hardcover,40,1996,1996,3.75,181,0
3791372467,Hardcover,56,2016,2016,3.56,181,0
1935954512,Hardcover,32,2015,2016,3.28,181,1
0698113535,Paperback,64,1982,1996,3.73,181,14
0140319891,Paperback,59,1972,1988,4.4,181,16
0399186409,Hardcover,36,2018,2018,3.87,180,0
0062278916,Hardcover,32,2016,2016,3.36,180,0
0399164383,Hardcover,32,2014,2014,3.44,180,0
0763667765,Hardcover,20,2013,2013,4.3,180,0
0763668222,Hardcover,32,2013,2013,3.44,179,0
082342040X,Paperback,32,2005,2006,3.94,179,1
0142500038,Paperback,40,2000,2003,3.84,179,3
0805012834,Hardcover,32,1995,1995,4.04,179,0
1481424963,Hardcover,288,2016,2016,4.28,179,0
2302017870,Hardcover,48,2010,2011,4.41,179,1
1550379828,Paperback,32,1994,1994,3.71,179,0
1623708028,Hardcover,34,2017,2017,3.66,178,0
0399167633,Hardcover,32,2015,2015,3.78,178,0
1596436328,Hardcover,32,2014,2014,3.32,178,0
1490909222,Kindle Edition,41,2013,2013,4.2,178,0
0794513255,Board Book,10,2006,2006,4.04,178,0
0689862148,Hardcover,32,2005,2005,4.13,178,0
0688151876,Hardcover,32,1997,1998,4.1499999999999995,178,1
0807534218,Paperback,32,1996,1996,4.1899999999999995,178,0
0843138246,Paperback,32,1988,1995,4.109999999999999,178,7
1484747186,Hardcover,48,2019,2019,4.1,177,0
1481428675,Hardcover,40,2015,2015,3.73,177,0
1849394113,Hardcover,32,2012,2012,3.77,177,0
0688040683,Paperback,40,1981,1984,3.98,177,3
2756032603,Hardcover,48,2013,2013,3.99,177,0
1939547334,Hardcover,44,2017,2017,3.81,176,0
0375971513,Hardcover,48,2014,2014,3.88,176,0
1402763964,Hardcover,32,2010,2010,4.08,176,0
159643189X,Hardcover,80,2007,2007,4.1499999999999995,176,0
0099983206,Paperback,32,1981,1993,4.39,176,12
0517566311,Hardcover,40,1987,1988,4.319999999999999,176,1
0060851244,Hardcover,176,2007,2007,3.75,176,0
1368052762,Hardcover,40,2020,2020,4.17,175,0
0374371237,Hardcover,40,2012,2012,3.61,175,0
0802721958,Hardcover,32,2010,2010,3.53,175,0
1845076001,Hardcover,32,2007,2007,4.05,175,0
140124050X,Paperback,128,2013,2013,3.93,175,0
1582460485,Paperback,32,1997,2001,3.91,175,4
1580893813,Hardcover,40,2013,2013,3.89,174,0
0060750405,Hardcover,40,2008,2008,3.95,174,0
0689862326,Hardcover,32,2006,2006,3.82,174,0
1616557249,Hardcover,180,2015,2015,4.29,174,0
155709392X,Hardcover,96,1900,2005,4.25,174,105
1939547318,Hardcover,32,2019,2019,4.46,173,0
1481470418,Hardcover,40,2017,2017,3.82,173,0
1596433965,Hardcover,32,2009,2009,3.62,173,0
1590785592,Hardcover,32,2008,2008,3.46,173,0
1406304182,Board Book,16,2007,2007,3.81,173,0
0763625175,Hardcover,32,2004,2004,4.1,173,0
0689839928,Hardcover,48,1964,2000,4.359999999999999,173,36
068971257X,Paperback,40,1980,1988,4.6499999999999995,173,8
1468058347,Kindle Edition,260,2011,2011,3.61,173,0
0062441094,Hardcover,40,2019,2019,4,172,0
1549303147,Hardcover,40,2019,2019,3.65,172,0
1433811375,Hardcover,32,2012,2012,4.02,172,0
076363364X,Hardcover,32,2007,2007,4.03,172,0
0810941864,Hardcover,38,2000,2000,3.87,172,0
0152023585,Hardcover,32,1960,1999,4.33,172,39
0345337964,Paperback,64,1986,1986,4.09,172,0
0374306168,Hardcover,32,2018,2018,3.65,171,0
080508813X,Hardcover,32,2013,2013,3.55,171,0
0824956478,Hardcover,32,2011,2011,4.54,171,0
0670011266,Hardcover,32,2009,2009,3.54,171,0
0735821356,Hardcover,24,2007,2007,3.81,171,0
0316770736,Hardcover,32,1995,1995,4.25,171,0
0823409740,Paperback,32,1991,1991,4.159999999999999,171,0
1880000202,Paperback,32,1993,2013,3.85,171,20
0590020846,Paperback,121,1958,1958,4.45,171,0
1536205877,Hardcover,32,2018,2018,3.46,170,0
1976294894,Kindle Edition,25,2017,2017,3.77,170,0
1492601535,Hardcover,32,2014,2014,3.47,170,0
0140567623,Paperback,40,1992,2000,3.66,170,8
0201029006,Hardcover,32,1969,1969,4.41,170,0
1590173325,Hardcover,64,1942,2009,3.75,170,67
1570982678,Paperback,32,1967,1999,3.99,170,32
0140146539,Paperback,417,1992,1992,4.25,170,0
1512441406,Hardcover,32,2018,2018,3.72,169,0
080758035X,Hardcover,32,2012,2012,4.17,169,0
0761353992,Hardcover,32,2010,2011,3.83,169,1
0061288640,Hardcover,32,1952,2009,3.24,169,57
1943145172,Hardcover,40,2017,2017,3.76,169,0
2205052314,Hardcover,48,2002,2002,4.05,169,0
0192751026,Paperback,219,1936,2002,3.64,169,66
1419731629,Hardcover,48,2018,2018,3.66,168,0
0062075535,Paperback,24,2013,2013,3.92,168,0
0743225007,Hardcover,192,2004,2004,4.4,168,0
0140501975,Paperback,48,1954,1977,3.89,168,23
1101940492,Hardcover,40,2018,2018,3.36,167,0
1627792996,Hardcover,40,2018,2018,3.78,167,0
0399169067,Hardcover,32,2018,2018,4.31,167,0
0761365893,Hardcover,32,2014,2014,4.17,167,0
1592701272,Hardcover,64,2012,2012,4.09,167,0
0789425556,Hardcover,64,1998,1999,4.1,167,1
0671411993,Hardcover,32,1969,1969,4.3,167,0
0375825339,Paperback,48,1999,2004,4.22,167,5
0689864620,Paperback,40,2001,2004,4.13,166,3
1771384093,Hardcover,72,2018,2018,3.73,166,0
0689873778,Kindle Edition,32,2011,2011,3.4099999999999997,166,0
088776830X,Paperback,128,1995,2008,3.57,166,13
0735264988,Hardcover,40,2020,2020,3.81,165,0
0358023041,Hardcover,32,2019,2019,3.79,165,0
1419725513,Hardcover,48,2019,2019,4.05,165,0
1419709526,Board Book,24,2015,2015,4.109999999999999,165,0
1854306243,Paperback,32,1999,2000,3.95,165,1
1402772092,Hardcover,32,2011,2011,4.22,165,0
1595821538,Paperback,424,2008,2008,3.91,165,0
0545904293,Hardcover,32,2018,2018,3.52,164,0
0230742505,Hardcover,32,2014,2014,4.02,164,0
0062224174,Hardcover,40,2011,2014,4.04,164,3
1847801358,Hardcover,32,2012,2013,4.26,164,1
1561454710,Hardcover,30,2009,2009,3.63,164,0
0439694523,Hardcover,32,2005,2005,3.71,164,0
1597072869,Hardcover,48,2008,2011,3.83,164,3
1591820766,Paperback,164,2003,2003,4.13,164,0
1903252016,Paperback,214,1931,2000,4.31,164,69
0590428594,Paperback,10,1966,1989,3.96,164,23
0823438643,Hardcover,40,2019,2019,3.4,163,0
1492657107,Hardcover,40,2018,2018,3.67,163,0
0544582624,Hardcover,32,2016,2016,3.81,163,0
1616559462,Hardcover,80,2016,2016,4.39,163,0
1101550430,Ebook,128,2012,2012,3.98,163,0
1421540665,Paperback,160,2012,2012,3.82,163,0
230201524X,Hardcover,48,2011,2011,4.470000000000001,163,0
0823437000,Hardcover,32,2018,2018,3.44,162,0
0823436659,Hardcover,36,2017,2017,4.09,162,0
0061993921,Hardcover,32,2011,2011,3.52,162,0
1580891195,Paperback,32,2008,2008,3.64,162,0
043990594X,Paperback,8,2006,2006,3.62,162,0
0763620890,Paperback,32,2001,2006,4.1499999999999995,162,5
0375830049,Board Book,26,1981,2004,3.92,162,23
0062297449,Hardcover,32,2014,2014,3.72,162,0
0061170488,Paperback,96,2008,2008,4.1499999999999995,162,0
0670062251,Hardcover,32,2007,2007,3.91,162,0
0553533886,Hardcover,40,2016,2016,3.29,161,0
0374310823,Hardcover,32,2015,2015,3.67,161,0
1561456195,Hardcover,32,2012,2012,3.78,161,0
0761352570,Hardcover,32,2011,2011,3.96,161,0
0375848886,Hardcover,40,2008,2008,3.81,161,0
0618111395,Paperback,32,1991,2001,3.79,161,10
158089447X,Hardcover,32,2015,2015,3.64,160,0
0803737378,Hardcover,32,2012,2012,3.49,160,0
1479271713,Paperback,32,2012,2012,3.94,160,0
144241202X,Hardcover,32,2011,2011,3.48,160,0
140485729X,Board Book,20,2010,2010,3.47,160,0
1423111494,Hardcover,40,2009,2009,3.69,160,0
0618507671,Hardcover,40,2007,2007,3.98,160,0
0764229400,Hardcover,32,1999,2004,4.3,160,5
0027443558,Hardcover,56,1994,1994,3.91,160,0
1626727929,Paperback,128,2018,2018,4.1499999999999995,160,0
0735228744,Hardcover,40,2019,2019,4.28,159,0
1627798056,Hardcover,32,2017,2017,3.62,159,0
0761461078,Hardcover,32,2012,2012,3.92,159,0
1402767943,Hardcover,30,1991,2010,3.94,159,19
0763620734,Hardcover,96,2003,2003,3.7,159,0
0316585440,Hardcover,32,2001,2001,3.76,159,0
0064436705,Paperback,32,1961,2000,3.46,159,39
0819304433,Hardcover,44,1971,1971,4.6499999999999995,159,0
0064408523,Paperback,96,2000,2003,3.57,159,3
1624147704,Hardcover,32,2019,2019,4.02,158,0
1515044386,Paperback,34,2015,2015,3.79,158,0
1419709534,Board Book,24,2015,2015,4.01,158,0
0152051147,Hardcover,40,2005,2005,3.54,158,0
0689865627,Hardcover,32,2005,2005,3.62,158,0
0812627369,Hardcover,48,2005,2005,4.08,158,0
0689864698,Hardcover,40,2004,2004,3.59,158,0
0670817414,Hardcover,32,1812,1993,3.72,158,181
2205073974,Hardcover,55,2015,2015,3.92,158,0
1449423035,Hardcover,224,2013,2013,4.04,158,0
1554533082,Hardcover,32,2010,2010,4.03,158,0
076360660X,Hardcover,32,1999,1999,4.37,158,0
0590423789,Paperback,128,1974,1989,3.8,158,15
0823402916,Hardcover,32,1977,1977,3.68,158,0
0385014708,Hardcover,28,1963,1963,4.1899999999999995,158,0
0399551395,Hardcover,32,2009,2015,3.8,157,6
0823428702,Hardcover,32,2013,2013,3.68,157,0
0547194870,Hardcover,32,2010,2010,3.73,157,0
0440422124,Paperback,44,1970,1985,4.44,157,15
097912851X,Kindle Edition,94,2015,2015,3.99,157,0
1934964980,Hardcover,152,2013,2013,3.54,157,0
0763624683,Hardcover,32,2007,2007,3.96,157,0
0448165759,Hardcover,40,1981,1981,4.76,157,0
0803760663,Board Book,10,1979,1979,4,157,0
0544774779,Hardcover,40,2017,2017,3.88,156,0
0545436540,Paperback,24,2012,2012,3.99,156,0
0823416216,Hardcover,32,2006,2006,3.85,156,0
0735819726,Paperback,36,2001,2004,3.9,156,3
0843102500,Paperback,32,1989,2003,4.33,156,14
0618150773,Hardcover,32,2002,2002,3.7,156,0
0375873481,Kindle Edition,24,2011,2011,4.08,155,0
1607180391,Paperback,32,2009,2009,3.74,155,0
076145439X,Hardcover,64,2008,2008,4.28,155,0
0618369163,Paperback,32,2000,2003,3.84,155,3
1613773544,Hardcover,148,2012,2012,3.44,155,0
1561454575,Hardcover,32,2008,2008,3.79,155,0
1846860946,Paperback,32,2004,2007,3.99,155,3
0763627437,Hardcover,48,2001,2005,4.34,155,4
0374375550,Hardcover,48,1997,2004,3.79,155,7
1584852747,Hardcover,47,2001,2001,3.99,155,0
0140544968,Paperback,64,1941,1992,2.97,155,51
1419726021,Hardcover,32,2016,2017,3.54,154,1
0439949106,Hardcover,30,2006,2006,3.92,154,0
0874836166,Hardcover,32,2001,2005,3.6,154,4
0876149131,Hardcover,32,1982,2002,3.77,154,20
0152024646,Paperback,32,1997,2000,3.88,154,3
1584691107,Paperback,32,2008,2008,4.06,154,0
1627798064,Hardcover,32,2018,2018,3.52,153,0
1585368830,Hardcover,32,2014,2014,3.73,153,0
0547126816,Hardcover,48,2010,2010,3.88,153,0
0060283025,Hardcover,32,2006,2006,4.2700000000000005,153,0
0142300543,Paperback,32,1974,2002,3.55,153,28
1886910510,Hardcover,72,1986,1999,4.24,153,13
0689712944,Paperback,32,1986,1989,4.23,153,3
0802852092,Hardcover,32,1853,2005,4.2700000000000005,153,152
0805064826,Paperback,40,1996,2000,3.74,153,4
0735230412,Hardcover,32,2019,2019,4.08,152,0
1609052862,Hardcover,40,2013,2013,3.38,152,0
0399250735,Hardcover,32,2010,2010,3.86,152,0
0723259968,Hardcover,24,2008,2008,4.1,152,0
0385751044,Hardcover,40,2006,2007,3.88,152,1
0027459217,Hardcover,32,1970,1993,3.74,152,23
0690046723,Hardcover,30,1966,1987,4.22,152,21
142311955X,Hardcover,40,2011,2011,3.64,151,0
0761459537,Hardcover,56,2011,2011,3.99,151,0
0152163956,Hardcover,56,2003,2003,3.77,151,0
1406516856,Paperback,328,1921,2007,4.29,151,86
1932425853,Hardcover,22,2003,2007,4.23,151,4
1563890208,Hardcover,255,1991,1997,4.01,151,6
1338112430,Hardcover,32,2017,2017,3.71,150,0
1416971297,Hardcover,40,2008,2008,3.77,150,0
081091218X,Hardcover,32,2007,2007,3.89,150,0
0679861661,Paperback,48,1994,1994,3.81,150,0
1467715980,Hardcover,52,2011,2013,3.54,150,2
0803737343,Hardcover,32,2012,2012,3.64,150,0
0803723032,Hardcover,40,2000,2000,3.98,150,0
1328994716,Hardcover,40,2020,2020,4.1899999999999995,149,0
1534146164,Ebook,40,2019,2019,4.18,149,0
153410643X,Ebook,32,2018,2018,3.58,149,0
0807541176,Hardcover,32,2016,2016,3.83,149,0
0763650978,Hardcover,16,1990,2010,3.95,149,20
0816679800,Hardcover,40,2014,2014,4.1899999999999995,149,0
1401238122,Paperback,128,2013,2013,4.18,149,0
1845070488,Hardcover,32,1981,2004,4.13,149,23
0395551129,Hardcover,32,1991,1991,3.93,149,0
1481459031,Hardcover,32,2018,2018,3.28,148,0
1481467077,Hardcover,48,2017,2017,3.86,148,0
0823424057,Hardcover,32,2013,2013,3.59,148,0
1416902112,Hardcover,40,2006,2006,3.4499999999999997,148,0
0735819734,Hardcover,14,1993,2004,3.58,148,11
1467712973,Hardcover,48,2013,2013,3.82,148,0
0761378847,Hardcover,40,2012,2012,3.6,148,0
0316083585,Hardcover,32,2004,2010,3.79,148,6
0064401332,Paperback,256,1971,2001,3.79,148,30
0152019553,Paperback,40,1994,1999,3.78,148,5
0525644644,Hardcover,40,2019,2019,3.78,147,0
1633224988,Hardcover,36,2018,2018,4.21,147,0
1419718843,Hardcover,44,2016,2016,4.03,147,0
1592701736,Hardcover,40,2012,2015,3.16,147,3
037597122X,Hardcover,48,2013,2013,4.07,147,0
1416940529,Hardcover,32,2009,2009,3.46,147,0
0670062928,Hardcover,40,2008,2008,4.1899999999999995,147,0
0688142087,Hardcover,32,1997,1997,4.04,147,0
0140547479,Paperback,32,1981,1993,4.119999999999999,147,12
0761356304,Paperback,48,2011,2011,4.1899999999999995,147,0
0972938869,Hardcover,40,2005,2005,4.35,147,0
0316075027,Hardcover,243,1967,1967,4.59,147,0
1589258592,Hardcover,24,2011,2011,3.78,146,0
0763634522,Hardcover,40,2009,2009,3.73,146,0
0714845116,Hardcover,72,2005,2005,4.159999999999999,146,0
0099363712,Paperback,32,1990,1994,4.359999999999999,146,4
0770515665,Hardcover,64,1977,1977,4.48,146,0
1452170347,Hardcover,48,2020,2020,4.109999999999999,145,0
0735843147,Hardcover,32,2014,2018,3.59,145,4
0857636138,Paperback,32,2016,2016,3.79,145,0
0805042032,Hardcover,44,1996,1996,4.22,145,0
2756041246,Kindle Edition,48,2014,2014,4,145,0
0140319727,Paperback,186,1984,1986,4.119999999999999,145,2
0690005326,Hardcover,172,1974,1974,3.94,145,0
0525553371,Hardcover,40,2019,2019,3.56,144,0
1770499229,Hardcover,48,2019,2019,4.1,144,0
1404852166,Board Book,20,2011,2011,3.71,144,0
0761458239,Hardcover,24,2011,2011,3.66,144,0
0802796346,Hardcover,32,1973,2007,3.8,144,34
0688144934,Hardcover,40,1997,1997,3.81,144,0
0307010295,Hardcover,24,1977,1993,3.95,144,16
1935179942,Hardcover,60,2016,2016,3.4099999999999997,144,0
0689711174,Paperback,32,1983,1987,3.92,144,4
1442498951,Hardcover,32,2014,2014,3.3499999999999996,143,0
1580893589,Hardcover,32,2012,2012,3.38,143,0
140274806X,Hardcover,24,2009,2009,3.27,143,0
158536293X,Hardcover,40,2007,2007,4.2700000000000005,143,0
0439950627,Paperback,30,1996,2006,4.2,143,10
0618510036,Hardcover,32,2006,2006,3.38,143,0
0689856911,Hardcover,32,2002,2003,3.78,143,1
1932425004,Hardcover,40,2003,2003,4.1,143,0
0689817738,Hardcover,96,1997,1997,4.28,143,0
0807525006,Paperback,32,1941,1994,4.28,143,53
0399215913,Hardcover,13,1988,1988,3.66,143,0
0375840354,Hardcover,64,1963,2007,4.28,143,44
0142407062,Paperback,144,2006,2006,3.8,143,0
0590457756,Paperback,32,1993,1995,4.08,143,2
0345315421,Paperback,64,1983,1983,3.99,143,0
0062297473,Hardcover,40,2018,2018,3.65,142,0
1101919175,Hardcover,46,2018,2018,3.76,142,0
0316230898,Hardcover,40,2015,2015,3.59,142,0
1452108404,Board Book,22,1977,2013,3.81,142,36
0618841989,Hardcover,32,2009,2009,3.85,142,0
0689835477,Hardcover,40,1981,2001,4.05,142,20
0761451692,Hardcover,32,2004,2004,3.91,142,0
0843129646,Hardcover,10,1986,1991,3.94,142,5
1416961089,Hardcover,40,2008,2008,3.63,141,0
1606994956,Hardcover,280,2011,2011,4.38,141,0
0979923859,Hardcover,40,2008,2008,3.04,141,0
0061542660,Hardcover,32,2008,2008,3.15,141,0
0374422575,Paperback,32,2000,2005,3.56,141,5
1558612815,Paperback,288,1976,2001,4.1499999999999995,141,25
0385416237,Hardcover,32,1993,1993,4.24,141,0
0441303803,Paperback,192,1963,1986,4.41,141,23
0807525502,Hardcover,32,2016,2016,3.32,140,0
0545450136,Hardcover,192,2012,2012,4.22,140,0
1845069463,Board Book,16,2008,2008,4.09,140,0
0140567674,Paperback,32,1998,2001,3.96,140,3
0786807954,Hardcover,32,1955,2001,3.67,140,46
0060214481,Hardcover,32,1983,1993,4.03,140,10
0590077678,Hardcover,39,1969,1980,4.1,140,11
1405217510,Board Book,26,1998,2005,3.96,140,7
1613431201,Kindle Edition,36,2017,2017,4.34,139,0
0060879440,Hardcover,32,2015,2015,3.86,139,0
0060589477,Hardcover,32,2005,2005,3.86,139,0
0152052518,Paperback,32,2000,2005,4.119999999999999,139,5
0394800338,Hardcover,61,1963,1963,4.01,139,0
1935179101,Hardcover,32,2011,2011,3.73,139,0
0152024719,Paperback,40,1995,2000,4.1899999999999995,139,5
0823442829,Hardcover,40,2019,2019,3.92,138,0
1427616450,Paperback,36,2006,2006,3.96,138,0
0786809515,Hardcover,40,2004,2004,3.78,138,0
0140553568,Paperback,24,1979,1994,3.93,138,15
0553154354,Paperback,48,1956,1984,3.96,138,28
1773212664,Hardcover,104,2019,2019,3.72,138,0
159643094X,Paperback,128,2007,2007,3.67,138,0
0689850964,Hardcover,96,1931,2002,4.25,138,71
0618081259,Paperback,32,1942,2000,3.75,138,58
110191789X,Hardcover,32,2018,2018,4.17,137,0
0008164363,Paperback,24,2015,2015,4.17,137,0
0823420515,Hardcover,32,2009,2009,3.85,137,0
0763634824,Board Book,16,2008,2008,3.49,137,0
0061240737,Hardcover,40,2007,2007,3.4099999999999997,137,0
0802789080,Hardcover,32,2004,2004,4,137,0
082341177X,Paperback,30,1993,1993,4.119999999999999,137,0
818190303X,Hardcover,28,2014,2014,3.85,137,0
076364580X,Paperback,56,2009,2009,3.99,137,0
0618452982,Hardcover,40,2002,2005,3.58,137,3
0064403114,Paperback,272,1984,2002,3.97,137,18
1563979764,Hardcover,44,1972,2001,4.359999999999999,137,29
0740706497,Hardcover,40,1959,2000,4.359999999999999,137,41
0544898915,Hardcover,32,2018,2018,3.62,136,0
0670016543,Hardcover,40,2015,2015,4.05,136,0
1554981921,Hardcover,36,2011,2012,3.27,136,1
0761455515,Hardcover,32,2009,2009,4.18,136,0
0689869207,Hardcover,48,2005,2005,4.14,136,0
0399231757,Hardcover,32,2001,2001,3.46,136,0
0385325401,Hardcover,32,2000,2000,3.85,136,0
1563976676,Hardcover,32,1999,1999,3.86,136,0
1608866262,Paperback,128,2011,2011,4.14,136,0
1402768184,Hardcover,72,1974,2010,4.41,136,36
0618310983,Paperback,32,1995,2003,3.79,136,8
0689319924,Hardcover,60,1997,1997,4.18,136,0
0062374524,Hardcover,32,2016,2016,3.46,135,0
1402787324,Hardcover,32,2013,2014,3.87,135,1
0152060138,Hardcover,14,2004,2007,4.1,135,3
0531070751,Paperback,32,1992,1996,3.76,135,4
0307605027,Hardcover,24,1987,1987,3.71,135,0
184507968X,Hardcover,40,2010,2011,4.21,135,1
0966441109,Paperback,40,1970,1999,4.109999999999999,135,29
158089805X,Hardcover,32,2018,2018,3.66,134,0
1627790160,Hardcover,32,2015,2015,3.65,134,0
0618510346,Hardcover,32,2007,2007,3.99,134,0
0670036935,Hardcover,32,2005,2005,3.83,134,0
1580896448,Hardcover,40,2016,2016,3.74,133,0
0823424103,Hardcover,32,2012,2012,3.85,133,0
0811864014,Hardcover,48,2009,2009,3.88,133,0
067005934X,Hardcover,144,2004,2004,4.470000000000001,133,0
0689873522,Hardcover,24,2003,2004,3.38,133,1
0889951616,Paperback,32,1995,2003,4.17,133,8
0823415171,Paperback,32,1998,1998,3.89,133,0
089919124X,Paperback,32,1974,1984,4.29,133,10
0810938480,Hardcover,38,1994,1994,4.14,133,0
0671694448,Paperback,48,1988,1990,4.21,133,2
0399187251,Hardcover,32,2015,2015,4.07,132,0
1442409347,Hardcover,40,2012,2012,3.74,132,0
1402757018,Board Book,24,1963,2008,4.359999999999999,132,45
0618563164,Hardcover,40,2007,2007,3.85,132,0
1613779062,Paperback,152,2014,2014,3.89,132,0
1604597526,Paperback,84,1922,2009,4.23,132,87
1582402787,Hardcover,112,1998,2003,3.89,132,5
0399166858,Hardcover,32,2019,2019,3.62,131,0
1580896839,Hardcover,32,2019,2019,3.48,131,0
0794506186,Hardcover,48,1998,2004,4.34,131,6
1631400908,Hardcover,96,2014,2014,3.98,131,0
230203628X,Hardcover,48,2013,2013,4.2700000000000005,131,0
1596434716,Hardcover,40,2010,2010,3.86,131,0
0590445596,Paperback,40,1944,1994,3.53,131,50
0992540414,Hardcover,223,1964,1966,4.31,131,2
0545741009,Hardcover,32,2016,2016,3.52,130,0
1939547016,Hardcover,40,2013,2013,3.88,130,0
1927018137,Hardcover,36,2013,2013,3.88,130,0
1612622364,Paperback,224,2007,2012,3.75,130,5
0805077286,Hardcover,32,2006,2006,3.94,130,0
0340878649,Paperback,34,2004,2005,3.88,130,1
0689848846,Hardcover,40,2003,2003,3.6,130,0
0375806431,Hardcover,40,2002,2002,4.08,130,0
0921103700,Paperback,32,1987,1987,4.46,130,0
1606994123,Paperback,208,2011,2011,3.18,130,0
1603090207,Paperback,64,2008,2008,3.59,130,0
1419734105,Hardcover,40,2019,2019,4.05,129,0
1596921358,Hardcover,32,1983,2006,4.119999999999999,129,23
0394808681,Hardcover,40,1952,2004,4.14,129,52
0525473238,Board Book,24,1990,2004,4.1,129,14
0931674263,Hardcover,48,1995,2003,4.46,129,8
0439073316,Paperback,40,1999,2002,3.94,129,3
0531300579,Hardcover,32,1997,1997,3.78,129,0
1423140389,Hardcover,40,2013,2013,3.56,129,0
0399254013,Hardcover,144,2009,2009,4.42,129,0
0671662708,Paperback,32,1974,1987,3.79,129,13
0062888781,Hardcover,40,2020,2020,4.41,128,0
1944903585,Hardcover,40,2019,2019,4.09,128,0
0525464395,Hardcover,24,2000,2000,3.82,128,0
0064440176,Paperback,64,1965,1978,3.63,128,13
1616558601,Paperback,688,2014,2015,4.08,128,1
275605769X,Hardcover,48,2015,2015,4.06,128,0
0375858776,Paperback,96,2010,2010,4.23,128,0
0060726970,Hardcover,32,2006,2006,3.63,128,0
0689848331,Hardcover,96,2002,2002,3.91,128,0
1589256433,Board Book,22,2013,2013,3.67,127,0
0823423174,Hardcover,32,2012,2012,3.36,127,0
0027826856,Hardcover,32,1994,1994,3.91,127,0
1605372234,Hardcover,32,2014,2015,3.8,127,1
0698115589,Paperback,48,1984,1999,4.2700000000000005,127,15
0140507361,Paperback,32,1988,1990,3.67,127,2
0060261919,Hardcover,32,1960,1960,4.05,127,0
0062675699,Hardcover,40,2018,2018,3.73,126,0
076367916X,Hardcover,32,2015,2016,3.42,126,1
1771383259,Hardcover,32,2016,2016,3.79,126,0
1590788761,Hardcover,32,2013,2013,3.81,126,0
1596434295,Hardcover,40,2009,2009,3.63,126,0
0375833412,Hardcover,72,1950,2005,4.1,126,55
1564026981,Paperback,32,1994,1996,4.06,126,2
0224008080,Hardcover,72,1973,1973,4.44,126,0
0525646655,Hardcover,40,2020,2020,3.66,125,0
0823436624,Hardcover,32,2017,2017,3.92,125,0
1620871734,Hardcover,32,2004,2012,3.94,125,8
1442408227,Hardcover,32,2010,2010,4.1,125,0
0698400623,Hardcover,32,2007,2007,3.97,125,0
1584302755,Hardcover,32,2007,2007,3.95,125,0
0060081759,Hardcover,26,2003,2004,3.88,125,1
0816745471,Paperback,32,1998,1998,3.93,125,0
1402785593,Hardcover,32,2011,2011,3.89,125,0
0618614885,Hardcover,32,2007,2007,3.48,124,0
0375834087,Hardcover,40,2007,2007,3.9,124,0
0613682378,Hardcover,32,2003,2003,3.99,124,0
0064441768,Paperback,48,1993,1994,3.65,124,1
0688065201,Paperback,32,1983,1986,3.47,124,3
2302042328,Hardcover,48,2014,2014,4.39,124,0
0689869649,Hardcover,32,1988,2005,3.65,124,17
0744517915,Paperback,32,1989,1991,4.22,124,2
148146096X,Hardcover,40,2017,2017,3.97,123,0
0888997795,Hardcover,32,2010,2010,4.03,123,0
0613345886,Hardcover,24,2000,2000,3.91,123,0
0899197051,Paperback,48,1985,1988,3.75,123,3
0802855075,Hardcover,32,2018,2018,3.72,123,0
1930900384,Hardcover,32,1962,2008,4.56,123,46
0152054227,Hardcover,32,2006,2006,4.06,123,0
0688104894,Paperback,32,1987,1991,3.3899999999999997,123,4
168119676X,Hardcover,48,2019,2019,4.02,122,0
1933718226,Hardcover,32,2011,2011,3.46,122,0
0802852947,Paperback,32,2004,2006,3.75,122,2
0439259827,Paperback,32,1987,2001,3.59,122,14
0525467971,Hardcover,32,2001,2001,3.87,122,0
1563978458,Hardcover,32,2000,2000,3.23,122,0
9024571332,Kindle Edition,288,2016,2016,4.18,122,0
159017500X,Hardcover,152,1956,2012,4.3,122,56
0980782341,Paperback,88,2011,2011,3.96,122,0
143420863X,Paperback,33,2008,2008,3.52,122,0
0887767044,Paperback,32,1979,2004,4.109999999999999,122,25
037580174X,Hardcover,48,1999,1999,4.02,122,0
0688149235,Hardcover,192,1966,1997,4.1,122,31
0310751020,Paperback,24,2015,2015,4.24,121,0
006166491X,Hardcover,24,2011,2011,3.54,121,0
1600602592,Hardcover,32,2009,2009,3.97,121,0
0060005378,Paperback,48,2000,2002,3.59,121,2
0679872434,Paperback,32,1996,1996,3.88,121,0
0333493427,Paperback,36,1979,1995,4.2700000000000005,121,16
0064440559,Paperback,64,1972,1984,3.83,121,12
0670523186,Hardcover,48,1972,1972,4.13,121,0
1442403764,Hardcover,64,2011,2011,3.91,121,0
0881069159,Paperback,32,2002,2002,4.14,121,0
072324409X,Hardcover,256,1923,1997,4.52,121,74
1984895575,Hardcover,32,2020,2020,3.73,120,0
1627793895,Hardcover,40,2018,2018,4.03,120,0
0618959742,Hardcover,32,2010,2010,3.98,120,0
951108044X,Hardcover,44,1984,2007,4.07,120,23
0553112805,Paperback,32,2001,2004,4.07,120,3
0439368820,Hardcover,40,2004,2004,3.79,120,0
0060294809,Hardcover,62,2001,2001,4.03,120,0
0307168506,Hardcover,174,1998,2001,4.119999999999999,120,3
0140562117,Paperback,32,1999,1999,4.430000000000001,120,0
030720314X,Board Book,26,1963,1998,4.1,120,35
0689867212,Hardcover,40,2004,2004,3.75,120,0
0374467250,Paperback,40,1993,2001,3.87,120,8
0590407821,Paperback,64,1970,1970,4.52,120,0
1534110259,Hardcover,40,2019,2019,4.2700000000000005,119,0
0399553789,Hardcover,40,2017,2017,3.5,119,0
1934706485,Hardcover,32,2009,2009,3.3899999999999997,119,0
1846166934,Hardcover,32,2007,2007,4.24,119,0
1905236751,Hardcover,32,2006,2006,3.87,119,0
0810949261,Hardcover,32,2005,2005,3.5,119,0
0763603619,Paperback,32,1996,1998,4.28,119,2
0688154735,Paperback,32,1990,1997,3.58,119,7
0887082548,Audiobook,40,1898,1992,3.91,119,94
0394849302,Paperback,31,1981,1981,3.58,119,0
1770494030,Hardcover,32,2013,2013,4.38,119,0
1626726817,Hardcover,40,2019,2019,3.63,118,0
1499805292,Hardcover,40,2018,2018,3.95,118,0
0062561685,Hardcover,32,2018,2018,3.75,118,0
0988659808,Paperback,64,2012,2012,3.95,118,0
076145957X,Hardcover,32,2011,2011,3.86,118,0
0863153720,Hardcover,32,1947,2002,3.97,118,55
0060295015,Hardcover,64,1971,2001,4.1899999999999995,118,30
0066238277,Hardcover,32,2001,2001,3.86,118,0
0439239737,Hardcover,40,2000,2001,3.81,118,1
0805077189,Hardcover,40,2009,2009,3.98,118,0
1596431296,Paperback,112,2001,2007,4.14,118,6
1842703587,Paperback,32,1984,1999,4.23,118,15
1576876799,Board Book,20,2014,2014,4.1499999999999995,117,0
0805094849,Hardcover,32,2013,2013,3.29,117,0
0374386889,Hardcover,32,2006,2006,3.82,117,0
006074247X,Hardcover,32,1960,2005,3.4499999999999997,117,45
0224014412,Hardcover,32,1977,1977,4.24,117,0
0399255230,Paperback,128,2012,2012,4.01,117,0
1402715994,Board Book,22,2003,2004,3.69,117,1
1338216384,Hardcover,48,2020,2020,3.97,116,0
1419721402,Hardcover,24,2016,2016,3.34,116,0
0803735774,Hardcover,32,2011,2011,3.73,116,0
0375844759,Hardcover,40,2010,2010,3.49,116,0
0439590787,Hardcover,40,2007,2007,3.85,116,0
0689858175,Hardcover,48,2004,2004,3.88,116,0
076138541X,Paperback,48,2012,2012,4.2700000000000005,116,0
0670885452,Hardcover,40,1982,1999,3.78,116,17
1250306795,Hardcover,32,2019,2019,3.82,115,0
1492677248,Hardcover,32,2019,2019,3.83,115,0
1471121151,Ebook,32,2016,2016,3.34,115,0
080753188X,Hardcover,32,2012,2012,4.03,115,0
0060559993,Hardcover,32,2006,2006,3.4099999999999997,115,0
0374399921,Hardcover,32,2002,2002,3.62,115,0
0763667803,Board Book,16,2014,2014,3.93,114,0
1596435097,Hardcover,32,2013,2013,3.72,114,0
1582461848,Hardcover,32,2007,2007,3.64,114,0
0307060500,Paperback,12,1971,1988,4.31,114,17
0895656892,Hardcover,31,1987,1988,3.75,114,1
8893983117,Kindle Edition,104,2018,2018,4.109999999999999,114,0
177147162X,Hardcover,32,2016,2016,2.92,114,0
0316735213,Hardcover,32,1999,2005,3.68,114,6
0140503897,Paperback,31,1983,1983,3.81,114,0
0823441644,Hardcover,40,2019,2019,3.55,113,0
1499805926,Hardcover,40,2018,2018,3.93,113,0
1771386533,Hardcover,36,2018,2018,3.4,113,0
0823436721,Hardcover,40,2017,2017,3.13,113,0
0670060828,Hardcover,32,2006,2006,3.66,113,0
0689504551,Hardcover,30,1988,1988,3.5,113,0
0590077740,Hardcover,40,1969,1980,4.42,113,11
0394832434,Paperback,32,1976,1976,4.05,113,0
1554515483,Paperback,104,2002,2013,3.67,113,11
0439919665,Hardcover,128,2008,2008,3.22,113,0
1554981794,Hardcover,32,2011,2012,4.41,112,1
1554533411,Hardcover,24,2005,2010,3.38,112,5
0763644285,Hardcover,40,2008,2009,3.78,112,1
0439903629,Hardcover,32,2008,2008,3.49,112,0
0810971100,Hardcover,32,2008,2008,4.119999999999999,112,0
0763608343,Hardcover,40,2003,2003,3.99,112,0
0385325215,Hardcover,32,1991,1997,4.48,112,6
1467785849,Hardcover,40,2010,2015,3.49,112,5
1847805167,Hardcover,32,2014,2014,4.18,112,0
0968102506,Paperback,154,1998,1998,4.28,112,0
0525645500,Hardcover,40,2019,2019,4.2,111,0
0996967915,Paperback,44,2016,2016,4.159999999999999,111,0
1910115185,Paperback,30,2014,2014,4.71,111,0
1596434988,Hardcover,28,2003,2009,4.14,111,6
0786816120,Hardcover,32,2006,2006,3.88,111,0
0395681936,Hardcover,32,1994,1994,4.359999999999999,111,0
0689813988,Paperback,32,1965,1997,3.14,111,32
1534426779,Hardcover,26,2018,2018,4.34,110,0
0803732856,Hardcover,32,2010,2010,3.97,110,0
068982114X,Hardcover,32,2007,2007,4.08,110,0
0763634662,Hardcover,48,2006,2007,3.87,110,1
0679890416,Hardcover,40,1998,2005,3.74,110,7
0689866976,Paperback,32,2001,2004,3.7,110,3
0618096353,Hardcover,32,2002,2002,4.02,110,0
0316866792,Paperback,44,1997,1999,4.25,110,2
0688076661,Hardcover,48,1989,1989,3.85,110,0
0698205286,Hardcover,32,1871,1981,3.78,110,110
1613777337,Paperback,148,2013,2013,4.08,110,0
1421522888,Paperback,192,2008,2008,4.31,110,0
148146289X,Hardcover,48,2020,2020,4.23,109,0
1984893440,Kindle Edition,32,2019,2019,3.58,109,0
1338339982,Paperback,48,2019,2019,3.49,109,0
1847809189,Hardcover,32,2017,2017,3.83,109,0
0807575364,Hardcover,32,2014,2014,3.98,109,0
1561455377,Hardcover,32,2010,2010,4.04,109,0
1561454176,Hardcover,44,2008,2008,4.17,109,0
1570612587,Hardcover,32,2002,2002,4.1499999999999995,109,0
0525336958,Hardcover,224,1971,1971,3.91,109,0
144241359X,Hardcover,32,2012,2014,3.87,108,2
0060504250,Hardcover,32,2007,2007,3.97,108,0
0060543280,Hardcover,32,2006,2006,4.13,108,0
1416927581,Hardcover,32,2006,2006,4.44,108,0
0374364826,Hardcover,36,2004,2004,4.119999999999999,108,0
0340714638,Paperback,122,1994,1994,3.65,108,0
0140547495,Paperback,32,1985,1993,3.73,108,8
150642189X,Hardcover,32,2016,2016,4.470000000000001,107,0
1409343812,Paperback,72,1960,2014,4,107,54
1467751243,Hardcover,24,2014,2014,3.5,107,0
1570918996,Board Book,10,2013,2013,3.71,107,0
0735822557,Hardcover,32,2009,2009,3.8,107,0
1564023389,Hardcover,32,1966,1994,4.26,107,28
1732516804,Kindle Edition,22,2018,2018,4.119999999999999,107,0
193778620X,Hardcover,32,2014,2014,4,107,0
089610009X,Hardcover,64,1972,2003,4.17,107,31
0439195691,Paperback,32,1996,2000,4.21,107,4
0399231587,Hardcover,32,2000,2000,3.58,107,0
1909263877,Hardcover,62,2016,2016,3.58,106,0
1580896227,Hardcover,40,2015,2015,3.86,106,0
0823419703,Hardcover,32,2014,2015,3.93,106,1
1580892728,Hardcover,32,2012,2012,3.71,106,0
1596434961,Hardcover,32,2009,2009,4.09,106,0
1416906975,Paperback,32,1977,2005,3.69,106,28
0307100790,Paperback,24,1968,1999,3.92,106,31
0689505493,Hardcover,32,1997,1997,3.97,106,0
0140548807,Paperback,32,1988,1993,4.14,106,5
1681198509,Hardcover,40,2020,2020,4.21,105,0
1536205680,Hardcover,32,2019,2019,3.59,105,0
1771383763,Hardcover,32,2018,2018,4.02,105,0
1770493808,Hardcover,32,2014,2014,3.94,105,0
0307975878,Hardcover,288,2012,2012,4.35,105,0
015206690X,Hardcover,40,2011,2011,3.19,105,0
0525459030,Hardcover,32,1997,1997,4.01,105,0
0735819769,Paperback,32,2003,2006,4.17,105,3
0340585803,Paperback,160,1967,1992,4.1499999999999995,105,25
0027253805,Hardcover,182,1985,1985,4.119999999999999,105,0
1520355580,Kindle Edition,175,2017,2017,4.7700000000000005,104,0
0545128234,Board Book,14,2009,2009,3.8,104,0
0553112538,Paperback,40,2002,2006,4.02,104,4
0060557133,Hardcover,64,1956,2005,3.86,104,49
0802852823,Hardcover,40,2004,2004,3.72,104,0
0849958733,Hardcover,32,1998,1998,3.93,104,0
0803717121,Hardcover,32,1636,1995,3.94,104,359
0689718020,Paperback,32,1991,1994,3.81,104,3
0786830093,Hardcover,32,1992,1994,4.02,104,2
0688131123,Paperback,32,1988,1994,3.61,104,6
0671501186,Hardcover,157,1984,1984,4.2,104,0
1608860957,Paperback,128,2012,2012,3.61,104,0
0531070360,Paperback,32,1990,1993,4.02,104,3
1454930136,Hardcover,32,2020,2020,4.319999999999999,103,0
1536205451,Hardcover,32,2019,2019,3.57,103,0
0823442381,Hardcover,32,1980,2019,3.83,103,39
0395928621,Paperback,40,1993,1998,4,103,5
0316285366,Hardcover,40,1972,1982,4.23,103,10
1847804500,Hardcover,40,2013,2013,4.09,103,0
1888472383,Paperback,144,2006,2006,4.29,103,0
1553376854,Paperback,32,2002,2004,3.84,103,2
1930650361,Hardcover,81,1935,2001,3.7,103,66
1682630056,Hardcover,36,2019,2019,3.77,102,0
1250159008,Hardcover,32,2018,2018,3.84,102,0
0807503797,Hardcover,32,2018,2018,4.08,102,0
0802728413,Hardcover,40,2012,2012,3.44,102,0
0807546445,Hardcover,32,2007,2007,3.88,102,0
0060539399,Hardcover,32,2007,2007,4.26,102,0
1561454192,Hardcover,32,2007,2007,3.5,102,0
1582347344,Hardcover,24,2006,2006,3.7,102,0
0316387037,Paperback,27,1969,1979,3.7,102,10
1897376936,Paperback,146,2009,2009,3.86,102,0
140524853X,Paperback,48,2009,2009,3.76,102,0
0689815352,Paperback,32,1993,1997,3.8,102,4
1250297427,Hardcover,40,2019,2019,3.7,101,0
1419723189,Board Book,34,2017,2017,4.07,101,0
1561455237,Hardcover,32,2010,2010,3.74,101,0
1405232919,Paperback,32,2007,2007,3.85,101,0
0399238654,Hardcover,32,2002,2002,3.61,101,0
0395913659,Hardcover,32,1972,1999,3.96,101,27
0679880852,Paperback,40,1985,1998,3.34,101,13
1421558785,Paperback,64,2013,2013,3.84,101,0
0606354697,Hardcover,64,2013,2013,3.84,101,0
0763616060,Hardcover,48,1983,2003,4.08,101,20
1584854804,Hardcover,47,2002,2002,3.86,101,0
0789481855,Paperback,40,1999,2001,3.66,101,2
1558584609,Hardcover,24,1926,1995,3.72,101,69
1580895468,Hardcover,32,2017,2017,4.08,100,0
1939547008,Hardcover,32,2013,2013,4,100,0
1585363634,Hardcover,32,2008,2008,3.91,100,0
0531303276,Hardcover,32,2000,2001,3.69,100,1
0060286873,Hardcover,40,1999,2000,4.109999999999999,100,1
0517586568,Hardcover,32,1993,1993,4.1,100,0
1595827234,Paperback,312,2007,2011,4.470000000000001,100,4
1466220937,Kindle Edition,101,2011,2011,3.86,100,0
1932065407,Hardcover,32,1974,2004,4.1499999999999995,100,30
1250130751,Hardcover,40,2018,2018,2.78,99,0
1481438395,Hardcover,32,2016,2016,3.92,99,0
0525421734,Hardcover,32,2010,2010,3.97,99,0
080508777X,Hardcover,32,2009,2009,2.78,99,0
030710253X,Hardcover,24,1986,1986,4.430000000000001,99,0
0395259363,Paperback,48,1967,1977,3.65,99,10
1684460379,Hardcover,32,2020,2020,4.109999999999999,99,0
1619634201,Hardcover,272,2016,2016,4.18,99,0
1576876438,Hardcover,56,2012,2013,4.33,99,1
0735817332,Hardcover,32,1987,2004,3.97,99,17
0152021051,Paperback,24,1995,2000,3.75,99,5
155521620X,Hardcover,291,1970,1990,4.03,99,20
158089710X,Hardcover,32,2017,2017,3.7,98,0
0976205629,Hardcover,48,2006,2006,4.04,98,0
037582877X,Hardcover,32,2004,2004,3.83,98,0
0590929550,Hardcover,32,1997,1997,3.93,98,0
1626721394,Paperback,128,2017,2017,3.81,98,0
0810941139,Hardcover,32,1996,2000,4.22,98,4
1477821139,Hardcover,182,1955,1955,4.35,98,0
0735841438,Hardcover,32,1996,2013,4.28,97,17
0062089285,Hardcover,24,2013,2013,3.54,97,0
0982993811,Hardcover,40,2007,2010,3.94,97,3
0874837790,Hardcover,28,2006,2006,3.94,97,0
0590483838,Paperback,32,1999,1999,3.4299999999999997,97,0
0307001504,Board Book,24,1992,1992,3.97,97,0
1597070912,Hardcover,112,2008,2008,3.68,97,0
1416900705,Hardcover,64,2005,2005,4.03,97,0
048642846X,Paperback,128,1913,2003,4.25,97,90
0689822057,Hardcover,32,1975,1998,4.21,97,23
0606073175,Hardcover,166,1994,1994,4.2,97,0
0374456461,Paperback,32,1990,1993,4.01,97,3
0374398976,Hardcover,48,2012,2012,3.81,96,0
141698321X,Hardcover,32,2008,2011,3.3099999999999996,96,3
0525478590,Hardcover,32,2011,2011,4.17,96,0
140275700X,Board Book,24,1989,2008,4.45,96,19
0439317703,Hardcover,32,2007,2007,3.61,96,0
1841489514,Hardcover,24,2002,2002,3.3499999999999996,96,0
0316109924,Paperback,32,1984,1985,3.89,96,1
074602309X,Hardcover,64,1900,1983,4.07,96,83
0399209980,Hardcover,32,1983,1983,4.1499999999999995,96,0
054705663X,Hardcover,32,2009,2009,3.67,96,0
076362554X,Hardcover,32,2005,2005,3.9,96,0
0803723547,Hardcover,40,1999,1999,4.31,96,0
0152710507,Hardcover,94,1967,1967,3.8,96,0
0525645934,Hardcover,44,2020,2020,4.319999999999999,95,0
1452142971,Hardcover,52,2020,2020,4.2700000000000005,95,0
1508501505,Kindle Edition,42,2015,2015,4.03,95,0
0763644994,Hardcover,56,2011,2011,3.38,95,0
1845077326,Paperback,32,1999,2007,3.54,95,8
0340918179,Paperback,24,1998,2006,4.159999999999999,95,8
1895565405,Hardcover,26,2005,2005,4.53,95,0
0316761133,Hardcover,32,1993,2005,3.83,95,12
0374384290,Hardcover,32,2004,2004,3.67,95,0
0374356025,Hardcover,36,2001,2001,3.94,95,0
0375805311,Hardcover,72,1948,2000,3.97,95,52
1935179349,Hardcover,32,2013,2013,3.84,95,0
0761385479,Paperback,40,2012,2012,3.56,95,0
1841482455,Hardcover,32,2003,2003,3.96,95,0
039955565X,Hardcover,32,2019,2019,3,94,0
1534404759,Hardcover,32,2019,2019,4.14,94,0
0007526296,Hardcover,32,2015,2015,3.78,94,0
0062279270,Hardcover,32,2015,2015,3.66,94,0
1404864954,Board Book,20,2011,2011,3.51,94,0
0525422765,Hardcover,32,2011,2011,3.9,94,0
1770492399,Hardcover,32,2011,2011,4.23,94,0
076145649X,Hardcover,64,2010,2010,4.07,94,0
0670011622,Hardcover,32,2010,2010,4.07,94,0
0439507391,Hardcover,64,2007,2007,3.81,94,0
1595720367,Hardcover,32,1977,2006,3.87,94,29
082341549X,Hardcover,32,2006,2006,3.7,94,0
0759524025,Paperback,142,2007,2007,3.61,94,0
0670058904,Hardcover,32,2004,2004,4.159999999999999,94,0
1563890577,Hardcover,224,1998,1998,4.13,94,0
1338151835,Hardcover,32,2019,2019,3.87,93,0
1633223841,Hardcover,32,2017,2017,3.58,93,0
0763692689,Hardcover,40,2015,2016,4.2700000000000005,93,1
0805096248,Board Book,26,2012,2012,3.63,93,0
0735821518,Hardcover,32,2007,2007,4.18,93,0
0765190583,Hardcover,32,1948,1998,4.08,93,50
2756022128,Hardcover,48,2012,2012,3.88,93,0
0786951400,Hardcover,144,2009,2009,4.319999999999999,93,0
0689839227,Hardcover,32,2005,2005,4.1,93,0
0060206454,Paperback,128,1973,1973,4.37,93,0
153442881X,Hardcover,32,2020,2020,4.3,92,0
1481491512,Hardcover,48,2020,2020,4.39,92,0
0062675931,Ebook,144,2018,2018,3.85,92,0
184148427X,Board Book,24,2000,2013,3.77,92,13
037033230X,Hardcover,32,2013,2013,4.119999999999999,92,0
0399254307,Hardcover,40,2012,2012,3.62,92,0
0803738048,Hardcover,32,2010,2012,3.52,92,2
1404864962,Board Book,20,2010,2011,3.59,92,1
0399251979,Hardcover,32,2010,2010,3.78,92,0
1582462801,Hardcover,32,2009,2009,4.04,92,0
076361176X,Hardcover,40,2000,2001,4,92,1
0316770922,Hardcover,32,1999,1999,4.09,92,0
0590843893,Paperback,32,1994,1994,3.65,92,0
0374310459,Hardcover,40,2019,2019,4.26,92,0
0590482904,Hardcover,32,1948,1997,3.98,92,49
0688063004,Hardcover,42,1945,1988,4.37,92,43
0140504176,Paperback,38,1956,1983,3.64,92,27
1250228107,Hardcover,128,2020,2020,4.54,91,0
0374318131,Hardcover,40,2013,2014,3.2,91,1
0375972056,Hardcover,40,2014,2014,4.05,91,0
0807588725,Hardcover,32,2013,2013,3.86,91,0
0823415775,Hardcover,32,2002,2002,4.1899999999999995,91,0
0374361495,Hardcover,32,2001,2001,4.23,91,0
0064435547,Paperback,24,1989,1999,3.91,91,10
0394833759,Paperback,28,1975,1975,4.3,91,0
1613778562,Paperback,104,2014,2014,4.03,91,0
1620100908,Paperback,136,2013,2013,2.9,91,0
1600602452,Hardcover,32,2011,2013,4.4,91,2
1932350098,Paperback,271,1952,2006,4.02,91,54
1368024602,Hardcover,40,2019,2019,3.7,90,0
153441990X,Board Book,24,2018,2018,3.98,90,0
0763644722,Hardcover,32,2010,2010,3.83,90,0
0310704464,Board Book,28,2002,2002,4.01,90,0
0803725051,Hardcover,32,2001,2001,3.19,90,0
1897376898,Paperback,186,2009,2009,3.82,90,0
1582402981,Hardcover,112,1999,2004,3.98,90,5
1879794012,Paperback,96,1995,1995,3.89,90,0
0062885928,Hardcover,40,2020,2020,4.35,89,0
0062206737,Hardcover,32,2015,2015,3.72,89,0
1580892302,Hardcover,32,2011,2011,3.74,89,0
1596430303,Hardcover,32,2003,2005,3.36,89,2
0060533021,Paperback,64,1964,2004,4.03,89,40
0811846091,Paperback,40,2000,2004,3.46,89,4
0618231374,Hardcover,32,2004,2004,4.01,89,0
0789481898,Paperback,32,1999,2001,3.46,89,2
0060272309,Hardcover,32,1999,1999,3.54,89,0
0525457445,Hardcover,24,1997,1997,3.8,89,0
0867130253,Hardcover,48,1990,1994,4.1899999999999995,89,4
1582409706,Hardcover,48,2008,2008,3.61,89,0
1842700332,Hardcover,32,2002,2002,3.56,89,0
076360335X,Hardcover,32,1990,1997,4.02,89,7
0241892104,Hardcover,32,1975,1975,4.03,89,0
1786036428,Hardcover,32,2019,2019,4.5,88,0
1936669498,Hardcover,32,2016,2016,4.02,88,0
1622531051,Ebook,38,2012,2012,4.42,88,0
0745961703,Paperback,32,2011,2011,4.41,88,0
0064461866,Paperback,40,1993,1996,3.74,88,3
9511118544,Hardcover,44,1990,1990,4.02,88,0
006022505X,Hardcover,32,1979,1979,3.67,88,0
1597072990,Hardcover,48,2009,2012,3.94,88,3
1845395050,Paperback,24,2011,2011,3.59,88,0
1590172523,Hardcover,52,1976,2007,3.88,88,31
1845073649,Paperback,32,2005,2006,3.97,88,1
1930964692,Paperback,160,2004,2005,4.28,88,1
0439169593,Hardcover,32,2001,2001,3.5,88,0
1783447176,Hardcover,32,2019,2019,3.9,87,0
1906250456,Board Book,26,2008,2009,3.06,87,1
0807503959,Hardcover,24,2006,2006,4.28,87,0
0064438694,Paperback,100,2001,2003,4.14,87,2
0590404342,Paperback,32,1970,1986,3.86,87,16
1406371807,Hardcover,320,2017,2017,4.23,87,0
0786950420,Hardcover,80,2008,2008,4.38,87,0
1845070496,Hardcover,32,1982,2004,3.86,87,22
0590484982,Hardcover,32,1996,1996,4,87,0
1368011055,Hardcover,64,2019,2019,4.01,86,0
1470170787,Paperback,20,2012,2012,4.17,86,0
1479294608,Kindle Edition,128,2012,2012,4.1499999999999995,86,0
1481815113,Kindle Edition,32,2012,2012,3.81,86,0
0140552618,Paperback,32,1995,1998,3.72,86,3
0525453369,Hardcover,32,1995,1995,3.92,86,0
1847805361,Hardcover,176,2015,2015,4.28,86,0
0152986103,Hardcover,32,1985,1985,4.1,86,0
0671961004,Hardcover,44,1979,1979,4.14,86,0
1250214009,Hardcover,32,2020,2020,3.22,85,0
1338118390,Hardcover,48,2019,2019,3.78,85,0
1773061046,Hardcover,32,2019,2019,3.92,85,0
1499800037,Hardcover,12,2015,2015,3.3899999999999997,85,0
0374325294,Hardcover,40,2005,2009,3.55,85,4
0399220356,Hardcover,32,2007,2007,3.55,85,0
0802780822,Hardcover,32,2006,2006,3.68,85,0
015205054X,Board Book,30,2000,2004,3.86,85,4
0802774881,Paperback,32,1985,1996,4.1499999999999995,85,11
0811801020,Hardcover,26,1992,1992,4,85,0
068971503X,Paperback,32,1974,1991,4.09,85,17
1609050991,Hardcover,40,2011,2011,3.62,85,0
2021044335,Hardcover,34,2011,2011,3.79,85,0
0786953470,Hardcover,80,2010,2010,4.46,85,0
0316713171,Hardcover,32,2001,2001,4.13,85,0
0141303603,Paperback,144,1997,2001,3.75,85,4
0062393499,Hardcover,32,2018,2018,3.58,84,0
0061958018,Hardcover,32,2012,2012,3.2,84,0
1612250580,Paperback,28,2011,2011,3.85,84,0
0763657352,Hardcover,32,2011,2011,3.96,84,0
006085975X,Paperback,432,2005,2006,3.93,84,1
0966427629,Hardcover,32,2004,2004,4.4,84,0
0152162275,Hardcover,32,2003,2003,3.83,84,0
0823416658,Paperback,28,2000,2001,3.55,84,1
0593120574,Hardcover,240,2020,2020,4.57,84,0
153620482X,Hardcover,104,2019,2019,4.54,84,0
1603090681,Hardcover,48,2011,2011,3.06,84,0
1406305332,Paperback,32,2006,2007,3.92,84,1
0590426583,Paperback,132,1987,1990,3.62,84,3
0688081843,Hardcover,32,1989,1989,3.9,84,0
0525517790,Hardcover,40,2019,2019,4.08,83,0
1534433031,Board Book,24,2018,2018,3.86,83,0
0735229228,Hardcover,32,2018,2018,3.4299999999999997,83,0
0983290482,Paperback,56,2013,2013,3.71,83,0
0988659832,Kindle Edition,50,2013,2013,4.14,83,0
1590788508,Hardcover,32,2012,2012,4.04,83,0
0732288223,Hardcover,32,2010,2010,4.04,83,0
0375866582,Hardcover,32,2010,2010,3.24,83,0
1426305923,Hardcover,48,2010,2010,4.07,83,0
1596431202,Hardcover,32,2010,2010,3.6,83,0
0735817820,Paperback,40,2001,2003,3.69,83,2
1558589805,Hardcover,32,1998,1998,4.02,83,0
0374456119,Paperback,32,1805,1993,3.3,83,188
1561487457,Hardcover,26,2012,2012,3.65,83,0
0785148426,Paperback,208,2010,2010,3.25,83,0
1553373030,Hardcover,96,1999,2009,3.6,83,10
0763625531,Hardcover,40,1941,2005,3.99,83,64
1569713855,Paperback,96,1999,1999,4.18,83,0
1590173430,Hardcover,32,1964,1964,4.07,83,0
0643531505,Paperback,114,1949,1964,3.72,83,15
0201092794,Hardcover,134,1961,1961,4.2,83,0
082344063X,Hardcover,32,2019,2019,3.9,82,0
054564786X,Board Book,16,2015,2015,3.57,82,0
0615545424,Hardcover,32,2012,2012,4.01,82,0
1419700332,Hardcover,32,2011,2011,3.34,82,0
0099417936,Paperback,32,2002,2003,4.09,82,1
0060225599,Hardcover,32,1971,1999,3.79,82,28
0395584086,Paperback,34,1986,1991,4.06,82,5
0590422944,Paperback,32,1983,1989,4.2,82,6
0201087758,Hardcover,24,1974,1974,4.430000000000001,82,0
3522410602,Hardcover,28,1972,1972,3.72,82,0
1607064626,Paperback,184,2011,2011,3.78,82,0
1609050347,Hardcover,40,2010,2010,3.4099999999999997,82,0
0785123067,Paperback,96,2006,2006,3.76,82,0
8847716357,Paperback,139,2005,2005,3.82,82,0
9056474316,Paperback,24,1997,1997,3.94,82,0
0064433919,Paperback,48,1995,1995,4.55,82,0
